[[116,113,116,112,115,117,112,116,44,113,110,9,9,9,9,9,78,55,9,9,9,115,113,87,115,9,9,9,9,9,9,9,9,9,9,9,9,20,132,120,116,115,113,116,113,115,116,113],
[115,114,110,9,9,116,115,43,71,114,9,9,9,9,9,9,116,72,116,112,9,9,133,116,113,9,9,9,9,9,9,9,9,9,9,9,22,23,24,9,9,9,9,9,9,116,112,116],
[116,116,9,9,9,9,9,78,55,9,9,9,9,9,9,116,87,73,115,133,9,9,9,9,9,9,9,9,9,9,9,9,9,9,9,121,122,29,9,9,9,9,9,9,9,120,115,112],
[112,115,113,9,9,9,113,116,73,11,9,9,9,9,9,119,116,72,116,9,9,132,9,9,9,9,9,9,9,9,9,9,9,9,133,41,42,12,9,9,9,9,9,9,9,9,116,115],
[113,116,9,9,9,112,114,112,44,116,21,9,9,9,9,113,43,71,115,9,9,9,124,9,9,9,9,9,9,9,9,9,9,9,131,59,18,46,47,18,60,132,9,9,9,116,112,113],
[116,11,9,9,9,116,115,116,78,57,26,57,55,124,9,9,72,123,133,9,9,9,13,9,9,9,9,9,9,9,9,9,9,9,59,34,10,10,10,10,48,115,9,9,9,120,115,116],
[115,114,9,9,9,131,116,87,113,116,31,116,44,116,9,22,23,24,9,9,9,132,9,9,9,9,132,132,9,9,9,9,9,9,58,10,10,10,10,36,61,116,9,9,9,9,116,112],
[116,9,9,9,9,9,113,115,116,9,9,120,45,132,9,9,73,131,9,9,9,9,9,9,15,9,9,116,9,9,9,9,9,115,58,10,10,10,10,48,116,9,9,9,9,9,9,115],
[117,11,9,9,9,9,133,116,133,9,9,9,72,131,9,9,78,56,80,55,115,14,9,9,9,9,9,133,9,9,9,9,9,132,62,63,63,33,10,48,131,9,9,9,9,9,9,116],
[116,116,9,9,9,9,9,9,9,9,9,113,45,116,9,9,9,9,9,78,55,133,9,9,132,9,9,132,9,9,9,9,9,9,131,9,9,62,63,61,9,9,9,9,9,9,116,115],
[115,112,132,9,9,9,9,9,9,9,9,131,72,14,9,9,9,9,9,9,73,9,9,9,9,9,9,9,9,9,9,9,9,9,9,9,9,9,115,132,9,9,9,9,9,9,9,116],
[114,116,9,9,9,9,9,9,9,9,9,22,23,24,9,9,9,9,9,116,72,116,9,116,9,9,9,9,9,132,9,9,9,9,9,9,9,9,9,9,9,9,9,9,9,9,9,113],
[116,113,11,9,9,9,9,9,9,9,9,9,72,115,9,9,9,9,9,115,45,113,16,116,9,9,14,9,9,132,9,9,9,9,9,9,9,9,9,9,9,9,9,9,9,116,113,112],
[115,112,116,11,9,9,9,9,9,9,9,116,78,56,55,9,9,9,9,110,44,112,9,17,9,9,9,9,9,9,9,9,9,9,9,9,9,9,9,9,9,9,9,9,9,9,115,116],
[112,87,113,115,9,9,9,9,9,9,9,113,115,116,72,17,9,9,43,56,71,116,9,9,9,9,132,9,9,9,9,9,9,9,9,9,9,9,9,9,9,9,9,9,9,9,9,112],
[113,116,112,131,9,9,9,9,9,9,9,131,112,9,78,55,9,9,45,116,9,9,9,9,9,9,9,9,9,9,9,9,9,9,9,9,9,9,9,9,9,9,9,9,9,9,9,115],
[112,110,9,9,9,9,9,9,9,9,9,9,9,9,9,72,15,9,72,112,21,9,113,116,9,9,9,9,9,9,9,9,9,9,9,9,9,9,9,9,9,9,9,9,9,9,9,113],
[118,9,9,9,9,9,9,9,9,9,16,9,9,116,113,45,112,9,78,56,26,80,55,116,115,9,9,17,9,9,9,9,9,9,9,9,9,9,9,9,9,9,9,9,9,9,113,116],
[113,9,9,9,9,9,9,9,9,9,132,116,113,114,112,20,110,9,9,131,31,112,73,113,115,112,115,115,15,9,9,17,132,9,9,9,9,9,9,9,9,9,9,9,9,9,112,116],
[115,9,9,9,9,9,9,9,9,9,9,133,116,9,22,23,24,9,9,9,9,116,44,115,116,115,113,9,9,9,9,9,131,9,9,9,9,9,9,9,9,9,9,9,9,9,116,112],
[116,118,11,9,9,9,9,9,9,9,9,9,9,9,9,29,113,9,124,9,9,43,71,116,9,9,115,112,9,9,9,9,132,9,9,9,9,9,9,9,9,9,9,9,9,9,115,113],
[116,112,116,118,116,9,9,9,9,9,9,9,9,9,116,72,115,9,9,9,9,78,56,57,55,9,9,115,9,9,15,9,9,9,9,9,9,9,9,9,9,9,9,9,9,9,9,120],
[112,118,113,115,133,9,9,9,9,9,9,9,9,116,112,73,116,112,9,9,9,13,115,9,73,9,9,9,9,9,9,9,9,9,9,9,9,9,9,9,9,9,9,9,9,9,9,9],
[116,116,116,110,9,9,9,9,9,9,9,9,9,9,115,78,55,116,14,9,9,9,9,9,44,123,9,9,9,9,9,9,9,9,9,9,9,9,9,9,9,9,9,9,9,9,9,119],
[115,116,11,9,9,9,9,9,9,9,9,9,9,132,87,116,78,57,55,9,9,9,9,9,78,55,131,59,60,9,9,132,9,9,9,9,9,9,9,9,9,9,9,115,11,9,9,115],
[116,112,116,9,9,9,9,9,9,9,9,9,9,116,9,9,9,9,72,11,9,9,9,9,9,72,116,58,48,133,9,9,9,9,14,9,9,132,9,9,119,115,116,112,116,9,116,112],
[112,115,110,9,9,9,9,9,9,9,9,9,9,9,9,9,112,43,71,115,9,9,9,9,9,78,76,77,35,60,9,112,17,9,9,9,9,9,9,9,116,118,113,87,113,117,113,116],
[116,116,9,9,9,9,9,9,9,9,9,9,9,9,9,119,116,73,115,118,9,9,9,9,9,120,116,82,10,74,75,57,55,16,9,9,9,9,9,116,115,117,116,112,116,112,116,115],
[114,116,11,9,9,9,9,9,9,9,9,9,9,9,9,116,115,78,55,113,21,9,9,9,9,9,9,58,10,81,116,113,20,9,9,9,13,9,9,9,113,116,112,116,115,113,87,116],
[112,116,118,116,133,9,9,9,9,9,9,9,112,9,119,113,116,115,78,25,26,27,55,131,9,9,9,62,63,61,9,22,23,24,9,9,9,9,9,9,9,9,116,117,113,116,116,112],
[116,116,112,116,112,9,9,9,9,9,9,9,116,113,112,87,112,116,9,9,31,9,73,114,9,9,9,113,116,9,9,9,29,112,9,9,9,9,9,16,9,9,9,115,116,113,115,118],
[115,116,87,116,9,9,9,9,9,9,9,119,87,116,115,116,115,113,116,9,9,9,72,115,113,9,9,15,9,9,9,43,71,116,9,131,9,133,9,9,9,9,9,9,9,116,117,113],
[116,112,116,9,9,9,9,9,9,9,9,131,113,116,118,112,117,116,115,131,9,9,73,118,9,9,9,9,9,9,131,72,113,110,9,9,9,113,9,115,9,9,17,9,9,113,116,116],
[116,113,9,9,9,9,9,9,9,9,9,9,9,115,116,116,115,112,120,113,9,9,78,55,9,9,9,9,9,119,43,71,116,9,9,132,113,112,116,9,9,9,9,9,113,116,113,115],
[115,116,9,9,9,9,9,9,9,9,9,9,9,133,112,113,116,9,9,9,9,9,115,72,112,132,9,9,123,115,73,118,110,9,43,57,57,57,79,79,55,124,9,9,9,9,116,116],
[87,113,9,9,9,9,9,9,9,9,9,9,9,9,131,115,133,9,9,9,133,113,116,78,79,57,55,9,9,116,72,115,9,9,73,133,132,116,132,9,73,132,9,13,9,116,113,112],
[116,116,11,115,133,9,9,9,9,9,9,9,9,9,9,9,9,9,9,9,113,87,115,116,115,113,20,9,9,120,45,116,112,9,73,9,9,9,9,9,73,112,9,9,9,113,116,117],
[115,116,112,116,112,9,9,9,9,9,9,9,9,9,9,9,9,9,9,9,9,115,116,110,9,22,23,24,9,9,72,113,43,57,71,9,9,9,9,9,20,116,9,16,9,9,9,116],
[116,117,116,113,116,113,9,9,9,9,9,9,9,9,9,9,9,9,9,9,9,9,116,116,9,9,29,15,9,9,78,57,71,9,13,9,9,9,9,22,23,24,9,9,9,9,113,112],
[113,116,116,116,116,110,9,9,9,9,9,9,9,9,9,9,9,9,9,9,9,9,133,113,9,9,73,132,9,9,116,115,116,9,9,9,9,9,9,9,29,9,9,9,9,116,112,116],
[116,112,116,115,9,9,9,9,9,9,9,9,9,9,9,9,9,9,9,9,9,9,9,9,9,9,72,9,9,9,9,9,9,9,9,9,9,9,9,9,73,112,131,9,9,9,116,115],
[115,116,118,116,116,9,9,9,9,9,119,115,11,9,9,9,9,9,9,115,116,115,116,9,9,133,78,55,133,21,119,14,9,9,9,113,133,43,57,79,71,116,9,9,116,9,116,116],
[112,116,115,116,112,116,9,9,9,119,87,116,116,9,9,9,9,9,9,131,117,116,112,9,132,9,9,78,25,26,27,57,55,112,9,115,43,71,116,115,112,9,9,115,116,116,115,113],
[116,117,116,87,113,116,9,9,119,115,116,116,113,116,9,9,9,9,9,9,115,110,9,9,9,9,9,131,132,31,9,115,72,115,112,116,72,9,9,116,116,113,9,9,113,116,87,118],
[113,116,113,116,117,116,11,9,117,116,113,87,115,116,118,131,9,9,9,9,9,9,9,9,9,9,9,9,9,9,9,116,78,55,113,87,45,116,9,9,9,9,9,116,116,115,116,112],
[115,113,116,115,116,116,115,116,116,114,116,131,114,116,112,113,133,9,9,9,9,9,9,9,9,9,9,9,9,9,116,87,112,72,112,116,72,116,115,116,117,113,116,112,115,116,112,113],
[117,116,112,116,116,113,116,113,133,113,117,116,116,87,116,115,116,9,9,9,9,9,9,9,9,9,9,9,9,9,9,113,9,73,118,115,78,79,57,55,116,116,113,116,112,116,116,112],
[113,116,116,113,115,116,112,87,116,117,116,115,112,113,116,115,110,9,9,9,9,9,9,9,9,9,9,9,9,9,9,9,9,72,116,87,116,113,112,78,55,116,113,118,115,116,112,87]]