[[10,10,10,10,10,10,10,10,10,10,10,10,10,10,10,10,10,10,10,10,10,10,10,10,10,10,10,10,10,10,10,10,48,112,115,116,113,117,112,115,116,113,110,9,9,9,9,9],
[10,10,10,10,10,10,10,10,10,10,10,10,10,10,10,10,10,10,10,10,10,10,10,10,10,10,10,10,10,10,10,10,35,18,18,18,60,115,116,118,116,9,9,9,9,9,9,9],
[10,10,10,10,10,10,10,10,10,10,10,10,10,10,10,10,10,10,10,10,10,10,10,10,10,10,10,10,10,10,10,10,10,10,10,10,48,9,9,115,110,9,9,9,9,9,9,9],
[10,10,10,10,10,10,10,10,10,10,10,10,10,10,10,10,10,10,10,10,36,63,63,63,33,10,36,63,63,63,63,63,63,63,33,10,48,111,9,9,9,9,9,9,9,9,9,9],
[10,10,10,10,10,10,10,10,10,10,10,10,10,10,10,10,10,36,63,63,61,116,112,9,62,63,61,9,114,117,116,70,116,115,62,89,61,111,9,9,9,9,9,9,9,9,9,9],
[10,10,10,10,10,10,10,10,10,10,10,10,10,10,10,10,36,61,108,116,9,9,9,9,9,9,9,9,9,9,9,9,113,112,132,88,116,110,9,9,9,9,9,9,9,9,9,9],
[10,10,10,10,10,10,10,10,10,10,10,10,10,10,10,10,48,111,9,9,9,115,9,9,9,132,9,131,9,9,9,9,116,110,9,72,113,9,9,9,9,9,9,9,9,9,9,9],
[10,10,10,10,10,10,10,10,10,10,10,10,10,10,10,10,48,113,9,112,124,116,9,9,9,131,9,133,9,9,9,9,133,9,9,73,112,13,21,9,112,11,9,9,9,9,9,9],
[10,10,10,10,10,10,10,10,10,10,10,10,10,10,10,10,48,111,9,9,115,113,9,9,9,133,9,132,9,9,9,9,9,9,9,78,57,25,26,27,55,113,9,9,9,9,9,9],
[36,63,63,63,63,33,10,10,10,10,10,10,36,63,63,63,61,112,9,9,9,9,9,9,9,9,9,9,9,9,9,9,9,9,9,9,9,9,31,9,73,116,9,9,119,116,11,119],
[61,113,9,112,115,58,10,10,10,10,10,36,61,117,116,110,9,124,9,9,9,9,9,9,9,116,9,9,9,112,9,9,9,9,9,9,9,9,9,9,12,87,11,9,109,115,112,113],
[115,111,9,9,116,58,10,10,10,10,10,48,114,112,9,9,9,9,9,9,9,9,9,9,9,115,9,9,9,116,9,9,9,113,9,9,9,9,9,59,46,47,18,60,133,113,120,116],
[117,116,9,9,116,62,63,63,63,33,10,48,113,115,9,9,9,9,9,9,9,115,9,127,83,84,9,9,9,133,9,9,9,116,9,9,9,9,9,58,10,10,10,74,75,55,115,87],
[116,87,9,9,131,108,116,13,112,62,89,61,116,9,9,9,9,9,9,9,9,112,9,90,91,92,113,112,9,9,9,9,9,9,9,9,9,9,9,58,10,10,10,81,132,78,55,113],
[121,116,11,9,9,9,9,9,120,115,88,115,125,102,9,9,9,9,9,9,9,9,9,96,97,98,116,9,9,9,9,9,9,9,133,9,9,9,9,62,63,89,63,61,116,115,73,116],
[117,115,116,9,9,9,9,9,9,123,20,9,104,105,9,9,9,9,9,9,9,9,9,115,116,112,113,9,9,9,9,9,9,9,113,116,9,9,9,9,113,88,131,14,115,112,44,114],
[87,112,9,9,9,9,9,9,9,22,23,24,9,9,9,9,9,9,9,9,9,9,9,9,9,9,115,9,9,9,9,9,9,113,112,9,9,9,9,9,115,44,116,9,120,113,45,118],
[115,9,9,9,9,9,9,9,9,9,29,9,13,9,9,9,9,9,9,9,115,116,112,115,113,9,9,9,9,9,9,9,9,9,115,9,9,9,43,56,57,71,115,9,9,17,72,112],
[113,11,9,9,9,9,9,9,9,9,20,132,9,9,132,9,9,9,9,9,9,9,9,116,129,37,38,115,116,113,9,9,9,9,113,9,9,9,73,116,108,113,124,9,9,112,78,55],
[116,112,113,9,9,9,9,9,9,22,23,24,9,9,126,103,9,123,9,9,9,9,9,113,49,50,51,9,9,9,9,115,116,133,112,9,9,9,20,133,9,9,9,9,9,119,115,73],
[115,116,110,9,9,9,9,9,9,113,29,9,9,9,106,107,9,9,9,9,9,9,9,112,64,65,66,9,9,9,9,112,123,115,9,9,9,22,23,24,9,9,9,9,115,112,87,44],
[116,9,9,9,9,9,9,132,116,87,88,131,9,9,9,9,124,9,9,9,116,113,112,116,133,132,131,9,9,9,9,116,113,133,116,9,9,9,29,9,9,123,9,9,9,120,113,78],
[87,112,9,9,9,9,9,109,59,18,46,18,18,60,9,9,9,9,9,9,9,9,133,9,9,116,9,9,9,9,9,9,9,9,9,9,9,43,71,9,9,9,9,9,9,9,116,110],
[110,9,9,9,9,9,9,116,62,33,10,10,10,48,9,9,9,9,9,9,9,9,116,9,9,131,9,9,9,9,131,9,9,124,9,9,131,45,132,9,9,9,9,9,13,9,9,9],
[9,9,9,9,9,9,9,131,112,58,10,10,10,48,14,15,9,16,9,9,9,9,9,9,9,9,9,9,9,9,132,9,9,9,9,9,9,72,9,9,119,112,16,9,9,9,9,9],
[9,9,9,9,9,9,9,9,16,58,10,10,10,35,18,18,60,15,9,9,9,9,133,131,132,9,9,9,9,9,133,9,9,9,116,115,113,88,115,14,87,116,9,9,9,9,9,9],
[9,9,9,9,9,9,13,59,18,34,10,10,10,10,10,10,48,17,9,14,9,9,9,9,9,9,9,9,9,9,9,9,9,9,13,59,18,46,47,18,60,114,113,9,9,9,9,9],
[9,9,9,9,9,9,17,58,10,10,10,10,10,10,10,10,35,60,9,9,9,9,9,9,9,9,9,9,9,9,9,9,9,9,59,34,10,10,10,10,48,115,9,9,9,9,9,9],
[9,9,9,9,9,9,13,58,10,10,10,10,10,10,10,10,10,48,16,9,9,9,9,9,9,9,9,9,9,9,9,9,9,9,58,10,10,10,10,10,48,9,9,9,9,9,9,9],
[113,131,9,9,9,9,9,58,10,10,10,10,10,10,10,10,10,48,15,9,9,9,9,9,13,9,9,9,9,9,9,9,9,132,58,10,10,10,10,10,48,131,9,9,9,9,9,9],
[122,112,9,133,113,70,9,58,10,10,10,10,10,10,10,10,10,48,14,9,9,133,9,9,9,9,9,113,16,9,15,131,9,9,62,63,33,10,10,10,48,116,11,9,9,9,9,9],
[113,133,9,116,59,18,18,34,10,10,10,10,10,10,10,10,10,48,121,122,9,9,9,9,9,9,17,116,59,18,60,115,9,9,9,112,62,33,10,10,35,60,111,9,9,9,9,9],
[112,9,9,109,62,63,33,10,10,10,10,10,10,10,10,10,36,61,41,42,9,17,116,70,13,59,18,18,34,10,48,9,9,9,9,115,116,58,10,10,10,48,16,9,9,9,9,119],
[116,9,9,132,114,112,58,10,10,10,10,10,10,10,10,10,48,116,9,9,9,59,18,18,18,34,10,10,10,10,48,131,9,14,9,9,117,58,10,10,10,48,9,9,9,9,9,113],
[113,9,9,9,131,9,58,10,10,10,10,10,10,10,10,10,48,113,9,9,131,58,10,10,10,10,10,10,10,10,48,132,9,9,9,9,116,58,10,10,10,48,15,9,9,9,119,116],
[115,116,9,9,9,116,62,33,10,10,10,10,10,10,10,10,48,112,132,9,9,58,10,10,10,10,10,10,10,10,48,9,9,9,9,9,59,34,10,36,63,61,113,9,9,116,112,87],
[120,132,9,9,9,131,132,58,10,10,10,10,10,10,10,10,35,60,9,9,9,62,33,10,10,10,10,10,10,36,61,131,9,132,112,113,58,10,10,48,116,114,116,9,9,9,113,118],
[9,9,9,9,9,9,9,58,10,10,10,10,36,63,63,63,63,61,113,9,9,132,58,10,10,10,10,10,10,48,114,132,9,115,59,18,34,10,10,48,115,116,87,116,11,9,120,116],
[9,9,9,9,9,9,14,58,10,10,10,10,48,114,115,108,116,112,115,9,9,133,58,10,10,10,10,10,10,48,111,9,9,9,58,10,10,10,10,35,18,18,18,60,115,11,9,114],
[9,9,9,9,9,9,116,62,33,10,10,10,48,111,116,9,120,113,132,9,9,9,62,63,33,10,10,10,10,48,111,9,9,9,58,10,10,10,10,10,10,10,10,48,112,116,9,115],
[9,9,9,9,9,9,113,115,58,10,36,63,61,111,9,9,9,9,9,9,9,9,9,123,58,10,36,63,63,61,115,9,9,116,62,63,63,63,33,10,36,33,10,35,18,18,18,18],
[9,9,9,9,119,115,87,116,58,10,48,114,108,133,9,9,9,9,9,9,9,9,9,9,62,89,61,116,108,108,132,9,9,131,115,13,14,17,62,63,61,62,63,63,63,63,33,10],
[11,9,9,9,116,59,18,18,34,10,48,116,9,9,9,9,9,9,9,9,9,9,9,9,133,88,133,9,9,9,9,9,9,9,9,9,9,9,9,116,124,9,108,110,9,119,58,10],
[116,133,9,9,109,58,10,10,10,10,48,131,9,133,131,9,9,9,9,9,9,9,9,9,9,20,9,9,9,9,9,9,9,9,9,9,9,9,9,9,9,9,9,9,9,109,62,63],
[115,112,9,9,133,58,10,10,10,10,35,18,60,113,111,9,9,9,9,9,9,9,9,9,22,23,24,9,9,132,70,116,70,132,9,9,9,9,9,9,9,9,9,9,9,120,108,117],
[118,116,11,9,9,58,10,10,10,10,10,10,48,116,118,116,11,9,9,9,9,9,9,9,131,29,132,131,9,112,43,56,55,111,9,9,9,9,9,9,9,9,9,112,115,11,9,116],
[116,115,116,115,113,62,63,63,63,63,33,10,48,115,112,117,113,118,9,9,119,116,11,9,115,78,57,79,57,80,71,113,44,115,9,9,9,9,9,9,9,59,18,18,60,113,131,115],
[87,117,116,118,116,112,113,115,116,115,58,10,48,113,118,116,112,115,116,11,112,113,116,70,113,112,116,112,115,116,115,87,73,111,9,9,59,18,18,18,18,34,10,10,48,112,113,120]]