[[9,9,9,9,9,9,9,9,9,9,9,9,9,9,9,9,9,9,9,9,9,9,9,9,9,9,9,9,9,9,9,9,9,9,9,9,9,9,9,107,109,44,105,109,59,109,107,45],
[9,9,9,9,9,43,111,9,9,9,9,9,9,9,9,9,9,9,9,9,9,9,9,9,9,9,9,9,9,9,9,9,9,9,9,9,9,9,9,9,107,109,109,111,105,110,105,70],
[9,9,9,107,110,108,107,109,110,9,106,111,9,9,9,9,9,9,9,9,9,9,9,9,9,9,9,9,9,9,9,9,9,9,9,9,9,9,9,9,9,9,9,9,109,107,111,109],
[9,9,108,9,109,28,65,65,65,65,35,110,45,9,9,9,9,9,9,9,9,9,9,9,9,9,9,9,9,9,9,9,9,9,9,9,9,9,9,9,9,9,9,9,107,109,110,107],
[9,9,9,9,106,56,42,42,42,42,42,110,107,111,60,9,9,9,9,9,9,9,9,9,9,9,9,9,9,9,9,9,9,9,9,9,9,9,9,9,9,9,9,9,9,9,109,109],
[9,9,9,111,107,56,42,42,42,42,42,111,109,106,110,9,9,9,9,9,9,9,9,9,9,9,110,110,9,9,9,9,9,9,9,9,9,9,9,9,9,9,9,9,9,9,109,111],
[9,9,9,95,108,56,42,42,42,42,42,33,65,35,108,109,60,9,9,9,9,9,9,9,9,110,9,9,9,9,9,9,9,9,9,9,9,9,9,9,9,9,9,9,9,9,111,109],
[9,9,9,9,109,54,42,42,42,42,42,42,42,42,108,111,106,9,9,43,111,45,9,9,9,109,9,9,9,9,9,9,9,9,9,9,9,9,9,9,9,9,9,9,110,107,109,97],
[9,9,9,9,110,108,111,108,91,34,42,42,42,42,109,107,86,110,111,108,109,111,9,9,9,9,9,9,9,9,9,9,9,9,9,9,9,9,9,9,9,9,9,9,9,9,9,109],
[9,9,9,9,111,106,107,111,9,109,56,42,42,42,107,112,29,30,107,106,97,9,9,9,9,9,9,111,9,9,9,9,9,9,9,9,9,9,9,9,9,9,9,9,9,9,9,107],
[9,9,9,9,9,9,84,110,9,108,54,42,42,107,109,36,37,38,84,109,9,9,9,9,111,9,110,107,9,9,9,9,9,9,9,9,9,9,9,9,9,9,9,9,9,9,9,109],
[9,9,9,9,9,9,9,9,9,110,106,111,108,106,111,47,48,49,106,108,106,9,9,9,109,9,109,111,9,9,9,9,9,9,9,9,9,9,9,9,107,108,45,9,9,9,9,71],
[9,9,9,9,9,9,9,9,9,111,97,107,110,108,86,110,106,114,61,62,110,9,9,43,106,9,9,96,9,9,9,9,109,43,111,60,9,9,9,9,58,109,111,110,9,9,107,110],
[9,9,9,9,9,9,9,9,9,9,9,9,84,113,31,32,110,72,73,74,95,70,9,108,106,70,9,9,9,9,9,9,108,110,108,106,111,9,9,43,106,108,106,9,9,9,9,105],
[9,9,9,9,9,9,9,9,9,9,9,9,110,39,40,41,107,87,87,89,109,71,9,68,108,108,9,9,108,9,9,9,111,28,65,35,110,9,9,107,109,86,9,9,9,9,9,95],
[9,9,9,9,9,9,9,9,9,9,9,111,110,50,51,52,107,110,111,108,107,109,9,106,110,71,9,9,110,9,9,9,110,56,42,42,79,9,9,9,111,110,111,9,9,9,9,9],
[9,9,9,9,9,9,9,9,9,9,9,110,109,106,109,110,105,111,105,110,106,106,9,69,111,107,111,110,69,9,9,9,107,56,42,42,79,107,9,9,9,9,9,9,9,9,9,9],
[9,9,9,9,9,9,9,9,9,9,9,9,9,107,107,106,109,110,107,109,108,109,9,109,109,58,107,106,109,111,108,106,109,56,42,42,79,110,109,108,106,9,9,9,9,9,9,9],
[9,9,9,9,9,9,9,9,9,9,9,9,9,9,85,109,96,107,85,107,106,9,9,9,107,110,111,109,111,109,111,111,108,56,42,42,33,65,65,65,35,111,45,9,9,9,9,9],
[9,9,9,9,9,43,111,107,9,9,9,9,9,9,9,9,9,9,9,9,9,9,9,9,110,107,95,108,106,108,111,28,65,53,42,42,42,42,42,42,42,111,108,9,9,9,9,9],
[9,9,9,9,58,110,109,108,110,9,9,9,9,9,9,9,9,9,9,9,9,9,9,9,106,111,111,107,108,108,109,56,42,42,42,42,42,42,42,42,42,106,110,9,9,9,9,9],
[9,9,9,105,108,106,111,58,109,9,9,9,9,9,111,59,111,43,110,107,9,9,9,9,9,109,110,97,109,84,105,54,42,42,42,42,42,42,42,42,42,108,107,60,9,9,9,9],
[9,9,9,43,110,109,107,106,108,9,9,9,9,9,106,107,110,111,109,111,109,9,9,9,9,95,111,109,106,111,95,106,91,34,42,42,42,42,42,42,42,110,106,108,111,9,9,9],
[9,9,9,111,108,97,95,110,107,110,9,9,111,28,65,65,65,65,35,111,110,106,107,109,9,9,107,108,107,109,111,110,108,109,56,42,42,42,42,42,42,110,109,9,110,9,9,9],
[9,9,9,9,9,108,111,84,110,106,107,108,109,56,42,42,42,42,42,79,9,9,9,110,110,9,9,109,110,70,9,9,9,111,56,42,42,42,42,42,42,108,111,9,9,9,9,9],
[9,9,9,9,68,106,106,111,108,28,65,65,65,53,42,42,42,42,42,111,107,45,9,111,109,111,9,9,106,108,9,9,9,110,54,42,42,42,42,42,105,108,97,9,9,9,9,9],
[9,9,9,9,108,69,111,106,111,56,42,42,42,42,42,42,42,42,42,79,108,111,9,43,111,107,9,9,9,110,9,9,9,106,108,105,108,111,110,109,106,111,110,60,9,9,9,9],
[9,9,9,106,59,106,111,111,106,56,42,42,42,42,42,42,42,42,42,33,65,65,35,110,111,106,9,9,9,9,9,9,9,84,105,111,109,108,107,110,105,97,95,111,9,9,9,9],
[9,105,110,110,108,45,43,108,111,56,42,42,42,42,42,42,42,27,91,91,34,42,42,79,9,9,9,9,43,108,9,9,9,9,9,9,9,109,9,9,9,9,9,9,9,9,9,9],
[9,9,111,111,111,106,107,111,109,56,42,42,42,42,42,42,42,79,9,9,56,42,42,110,107,108,110,9,109,45,9,9,9,9,9,9,9,110,105,9,9,9,9,9,9,9,9,9],
[9,9,105,9,106,28,65,65,65,53,42,42,42,42,42,42,42,79,9,9,56,42,42,107,110,108,111,107,106,111,9,9,9,9,9,9,111,110,109,9,9,9,9,9,9,9,9,9],
[9,9,9,9,108,56,42,42,42,42,42,42,42,42,42,42,42,33,65,65,53,42,42,109,106,111,109,109,108,110,9,9,9,9,9,9,9,95,106,9,9,9,9,9,9,9,9,9],
[9,9,9,9,9,54,42,42,42,42,42,42,42,42,42,42,42,42,42,42,42,42,106,108,97,9,9,111,106,86,9,9,9,9,9,9,9,9,9,9,9,9,9,9,9,9,9,9],
[9,9,9,9,107,111,91,91,34,42,42,42,42,42,42,42,42,42,106,109,109,108,106,109,108,9,9,108,111,110,9,9,9,9,9,9,9,9,9,9,9,9,9,9,9,9,9,9],
[9,9,9,9,95,106,111,109,56,42,42,42,42,42,42,42,42,111,108,107,109,111,108,45,9,9,9,9,9,9,9,9,9,9,9,9,9,9,9,9,9,9,9,9,9,9,9,9],
[9,9,9,9,9,9,110,108,56,42,42,42,42,42,42,42,109,106,86,9,9,9,9,110,9,9,9,9,9,9,9,9,9,9,9,9,9,9,9,9,9,9,9,9,9,9,9,9],
[9,9,105,9,9,111,107,109,56,42,42,42,42,42,42,42,107,110,109,9,9,9,9,9,9,9,9,9,9,9,9,9,9,9,9,9,9,9,9,9,9,9,9,9,9,9,9,9],
[9,9,111,106,111,108,108,106,54,42,42,42,42,42,42,111,109,107,111,109,107,109,9,9,9,9,9,9,9,9,9,9,9,9,9,9,9,9,9,9,9,9,9,9,9,9,9,9],
[9,9,9,106,71,108,105,110,111,108,107,111,106,106,106,108,111,9,9,9,9,9,9,9,9,9,9,9,9,9,9,9,9,9,9,9,9,9,9,9,9,9,9,9,9,9,9,9],
[9,9,108,106,111,111,111,95,108,109,106,108,107,111,106,110,70,9,9,9,9,110,9,9,9,9,9,9,9,9,9,9,9,9,9,9,9,9,9,9,9,9,9,9,9,9,9,9],
[9,9,9,85,86,110,68,106,84,111,106,105,111,69,107,111,71,9,9,9,9,9,9,9,9,9,9,9,9,9,9,9,9,9,9,9,9,9,9,9,9,9,9,9,9,9,9,9],
[9,9,9,9,69,106,111,97,44,108,108,106,106,68,107,109,70,9,9,9,9,9,9,9,9,9,9,9,9,9,9,9,9,9,9,9,9,9,9,9,9,9,9,9,9,9,9,9],
[9,9,9,43,111,106,85,110,106,107,96,95,105,84,85,96,97,60,106,107,106,70,108,9,9,9,9,9,9,9,9,9,9,9,9,9,9,9,9,9,9,9,9,9,9,9,9,9],
[9,9,69,106,111,9,9,9,9,9,107,9,9,9,106,9,105,106,85,108,96,107,97,9,9,9,9,9,9,9,9,9,9,9,9,9,9,9,9,9,9,9,9,9,9,9,9,9],
[9,9,95,96,97,9,9,9,9,9,9,9,9,9,9,9,9,9,107,9,9,9,108,9,9,9,9,9,9,9,9,9,9,9,9,9,9,9,9,9,9,9,9,9,9,9,9,9],
[9,9,9,9,9,9,9,9,9,9,9,9,9,9,9,9,9,9,9,9,9,106,109,9,9,9,9,9,9,9,9,9,9,9,9,9,9,9,9,9,9,9,9,9,9,9,9,9],
[9,9,9,9,9,9,9,9,9,9,9,9,9,9,9,9,9,9,9,9,9,9,9,9,9,9,9,9,9,9,9,109,107,60,9,108,45,9,9,9,9,9,9,9,9,9,9,9],
[9,9,9,9,9,9,9,9,9,9,9,9,9,9,9,9,9,9,9,9,9,9,9,9,9,9,9,9,9,44,111,110,108,106,110,96,97,9,9,9,9,9,9,9,9,9,9,9]]