[[9,9,9,9,9,9,9,9,9,9,9,9,9,9,9,9,9,9,9,9,9,9,9,9,9,9,9,9,9,9,9,9,9,9,9,131,58,10,10,10,10,10,10,10,10,10,10,10],
[9,9,9,9,9,9,9,9,9,9,9,9,9,9,9,9,9,9,9,9,9,9,9,16,87,131,9,9,9,9,9,9,9,9,9,132,58,10,10,10,10,10,10,10,10,10,10,10],
[9,9,9,9,9,9,9,9,118,9,9,9,9,9,9,9,9,9,9,9,9,16,59,18,60,114,133,16,9,9,9,9,9,9,9,59,34,10,10,10,10,10,10,10,10,10,10,10],
[9,9,9,9,9,9,9,9,113,11,9,9,9,114,133,17,131,9,9,15,59,18,34,10,35,18,60,9,132,116,9,9,9,9,9,58,10,10,10,10,10,10,10,10,10,10,10,10],
[9,9,9,9,9,9,9,112,133,111,9,9,59,18,18,18,60,14,9,59,34,10,10,10,10,10,35,18,60,133,9,9,9,9,16,58,10,10,10,10,10,10,10,10,10,10,10,10],
[9,9,9,9,9,9,112,112,115,131,59,18,34,10,10,10,35,18,18,34,10,10,10,10,10,10,10,10,48,120,114,9,9,117,114,58,10,10,10,10,10,10,10,10,10,10,10,10],
[9,9,9,9,9,9,113,114,112,59,34,10,10,36,63,63,63,63,63,33,10,10,10,10,10,10,10,10,35,18,60,9,9,59,18,34,10,10,10,10,10,10,10,10,10,10,10,10],
[9,9,9,9,9,15,112,111,59,34,10,10,10,48,112,113,112,132,11,58,10,10,10,10,10,10,10,10,36,63,61,9,9,62,63,33,10,10,36,63,63,63,33,10,10,10,10,10],
[9,9,9,9,9,9,9,131,58,10,36,63,63,61,114,108,117,114,117,62,63,63,63,63,33,36,63,63,61,9,9,9,9,9,133,62,63,63,61,112,112,118,62,63,33,10,10,10],
[9,9,9,9,9,9,9,9,58,10,48,112,112,113,111,9,9,9,131,117,114,108,131,9,62,61,9,9,9,9,9,9,9,9,132,114,117,114,108,117,115,112,132,133,58,10,10,10],
[9,9,9,9,15,9,9,59,34,10,48,114,108,108,133,9,9,9,9,9,9,9,9,9,9,9,9,9,9,9,9,9,9,9,9,9,9,118,112,87,9,9,9,111,62,33,10,10],
[9,9,9,87,11,9,9,58,10,36,61,131,9,9,9,9,9,9,9,9,9,9,9,9,9,9,9,9,9,9,9,9,9,9,9,9,9,9,9,9,9,9,9,118,11,62,33,10],
[9,9,109,113,118,9,59,34,36,61,112,114,9,9,9,9,9,9,9,9,9,9,9,114,108,133,59,60,9,9,9,9,9,9,9,9,9,9,9,9,9,9,9,133,117,11,58,10],
[9,9,114,110,59,18,34,36,61,114,108,110,9,9,9,9,9,9,9,9,9,9,9,111,59,18,34,35,60,9,9,9,9,9,111,9,9,9,9,9,9,9,9,9,9,111,58,10],
[9,119,115,59,34,10,10,48,119,111,9,9,9,9,9,9,9,9,9,9,9,9,9,132,58,10,10,10,48,115,123,9,113,114,133,9,9,9,9,9,9,9,9,9,9,118,58,10],
[9,112,131,58,10,10,10,48,113,118,9,9,9,9,9,9,9,9,9,9,9,9,9,111,58,10,10,10,35,60,132,9,9,9,9,9,9,9,9,9,9,9,9,132,113,132,58,10],
[9,133,59,34,10,10,10,48,120,114,9,9,9,9,9,9,9,9,9,9,9,9,9,110,58,10,10,10,10,35,18,60,133,9,9,9,9,9,9,87,113,112,112,112,114,133,58,10],
[9,16,58,10,10,10,10,35,60,112,9,9,9,9,9,9,9,9,9,9,9,9,9,59,34,10,10,10,10,10,10,48,114,9,9,9,9,9,9,115,115,112,113,114,110,59,34,10],
[9,9,58,10,10,10,10,10,35,60,9,9,9,9,112,9,9,9,9,9,9,9,9,58,10,10,10,10,10,10,10,48,111,9,9,9,9,9,9,112,112,114,132,110,59,34,10,10],
[9,9,58,10,10,10,10,10,36,61,9,9,9,9,132,9,9,9,9,9,9,9,59,34,36,63,63,63,63,33,10,48,118,9,9,9,132,115,112,115,114,110,59,18,34,10,10,10],
[9,9,58,10,10,10,10,10,48,9,9,9,9,9,9,9,9,9,9,132,131,9,62,63,61,112,112,113,11,62,33,35,60,113,131,9,133,117,132,108,133,59,34,10,10,10,10,10],
[9,9,58,10,10,10,36,63,61,9,9,9,59,18,60,9,9,9,9,9,9,9,117,116,113,132,112,116,118,132,62,33,35,18,60,9,9,59,18,18,18,34,10,10,10,10,10,10],
[9,9,58,10,10,10,48,112,115,9,9,9,62,10,35,18,18,18,18,60,9,9,133,108,117,114,108,132,9,9,118,62,63,63,61,9,9,62,63,33,10,10,10,10,10,10,10,10],
[9,9,62,33,10,36,61,111,9,9,9,9,9,62,63,33,10,10,36,61,131,9,9,9,9,9,9,9,9,9,108,117,114,108,131,9,131,113,118,62,33,10,10,10,10,10,10,10],
[9,9,9,62,33,48,114,133,9,87,118,9,9,9,9,58,10,36,61,114,132,9,9,9,87,131,9,9,9,9,9,9,9,9,9,9,9,9,113,118,58,10,10,10,10,10,10,10],
[9,9,15,9,58,48,116,9,9,9,9,118,9,9,9,58,10,48,114,110,9,9,9,9,133,118,9,9,9,9,9,118,9,9,9,9,9,9,112,131,58,10,10,10,10,10,10,10],
[9,9,9,16,58,48,111,9,9,9,9,131,9,112,132,58,10,48,111,9,9,9,9,113,121,122,131,9,9,9,9,114,9,9,9,9,131,114,110,59,34,36,63,63,63,33,10,10],
[9,9,9,9,58,48,118,132,9,9,9,9,9,9,9,58,10,48,111,9,9,9,9,115,41,42,110,9,9,9,9,111,9,9,9,9,112,111,59,34,36,61,9,9,9,62,33,10],
[9,9,9,132,58,48,113,111,9,9,9,9,9,9,9,58,10,48,118,133,9,9,9,133,114,132,133,9,117,114,132,131,9,9,9,9,114,110,58,10,48,9,9,9,9,9,58,10],
[9,9,115,114,58,48,117,111,9,9,9,9,9,9,59,34,10,48,113,118,70,131,9,9,9,9,9,9,9,9,9,9,9,131,87,115,111,59,34,10,48,9,9,9,9,9,62,33],
[9,9,133,59,34,35,60,111,9,9,9,9,9,59,34,10,10,35,60,112,113,118,9,9,9,9,9,9,9,9,9,9,9,87,112,115,132,58,10,10,48,9,9,9,9,9,133,58],
[9,9,16,58,10,10,48,118,132,116,9,59,18,34,10,10,10,10,35,60,112,114,9,9,9,9,9,9,9,9,9,9,9,115,113,113,111,58,10,10,48,9,9,9,9,9,111,58],
[9,9,9,58,10,10,35,18,60,118,9,62,33,10,10,10,10,10,10,35,60,118,70,87,9,9,9,9,9,9,9,9,9,9,112,114,110,58,10,36,61,132,9,9,9,115,111,58],
[9,9,9,58,10,10,10,10,48,114,9,9,62,33,10,10,10,10,10,10,35,60,112,114,9,9,9,9,9,9,9,9,9,9,113,111,59,34,36,61,133,87,9,9,9,114,110,58],
[9,9,9,58,10,10,10,10,48,118,11,9,9,62,63,63,63,63,63,33,10,48,113,132,9,9,9,9,9,9,9,9,87,115,114,110,58,36,61,114,110,9,9,9,9,132,9,58],
[9,9,133,62,33,10,10,10,35,60,118,11,9,9,9,87,113,115,133,62,33,48,112,118,9,9,9,9,9,9,9,9,113,112,133,59,34,48,114,112,9,9,9,9,9,118,11,58],
[9,9,117,115,62,33,10,10,10,35,60,118,132,133,9,9,9,115,113,131,58,48,113,114,9,9,9,9,9,9,9,9,117,113,111,58,36,61,111,9,9,9,9,9,9,9,111,58],
[9,9,9,112,118,62,63,33,10,10,35,18,60,111,9,9,9,114,108,132,62,61,108,131,9,9,9,9,9,9,9,9,133,108,131,62,61,132,110,9,9,9,9,9,9,9,118,58],
[9,9,9,9,131,115,132,62,63,63,33,36,61,111,9,9,9,9,9,9,9,9,9,9,9,9,9,9,9,9,9,9,9,9,9,9,9,9,9,9,9,9,9,9,9,9,114,58],
[9,9,9,9,9,117,114,15,13,9,58,48,114,133,9,9,9,9,9,9,9,131,70,133,9,9,9,9,9,9,9,131,59,60,9,9,9,9,9,9,9,9,9,9,9,9,111,58],
[9,9,9,9,9,9,9,9,9,9,62,61,9,9,9,9,9,9,9,9,59,60,113,118,9,9,9,9,9,9,9,133,58,35,18,60,9,9,9,9,9,9,9,9,9,114,110,58],
[9,9,9,9,9,9,9,9,9,9,9,9,9,9,9,9,9,9,9,9,58,35,60,115,9,9,9,9,9,112,113,59,34,10,10,48,131,9,9,9,9,9,9,9,112,111,59,34],
[9,9,9,9,9,9,9,9,9,9,9,9,9,9,9,9,9,9,9,9,58,10,48,112,118,11,9,9,9,113,114,58,10,10,10,48,111,9,9,9,9,116,115,132,113,111,58,10],
[9,9,9,9,9,9,9,119,131,11,59,60,9,9,9,9,9,9,9,59,34,10,35,60,113,111,9,9,9,108,110,58,10,10,10,48,117,118,9,9,9,113,112,112,114,110,58,10],
[9,9,9,9,9,9,132,87,112,110,58,48,9,9,9,9,9,9,59,34,10,10,10,48,115,111,9,9,9,9,59,34,10,10,10,48,132,108,117,9,9,112,113,114,110,59,34,10],
[9,9,9,9,9,9,113,133,59,18,34,48,114,108,131,108,132,59,34,10,10,10,10,35,60,118,87,118,133,59,34,10,10,10,10,35,18,60,120,108,108,117,114,110,59,34,10,10],
[87,118,9,9,9,9,110,59,34,10,10,35,18,18,18,18,18,34,10,10,10,10,10,10,35,18,18,18,18,34,10,10,10,10,10,10,10,35,18,18,18,18,18,18,34,10,10,10],
[108,108,133,9,9,9,59,34,10,10,10,10,10,10,10,10,10,10,10,10,10,10,10,10,10,10,10,10,10,10,10,10,10,10,10,10,10,10,10,10,10,10,10,10,10,10,10,10]]