[[42,42,42,42,79,69,111,106,111,108,107,96,86,9,9,9,9,9,9,9,9,9,9,9,9,9,9,9,9,95,85,107,108,109,110,108,110,96,85,96,95,107,108,111,109,108,107,111],
[42,42,42,42,79,69,110,107,110,85,97,9,9,12,9,9,14,9,9,9,14,9,9,9,9,9,9,9,9,9,9,84,110,111,108,85,86,9,9,9,9,84,17,110,107,106,19,107],
[42,42,42,42,33,35,95,106,70,9,9,9,10,9,9,13,9,9,9,9,9,9,9,15,9,9,10,9,9,10,9,9,95,107,106,9,9,9,10,9,9,9,106,108,111,109,110,109],
[42,27,91,91,91,34,79,84,109,9,11,9,9,9,9,9,9,9,9,9,9,9,9,9,9,9,9,9,9,9,9,9,9,110,109,9,9,9,9,9,10,9,9,95,109,107,108,111],
[42,79,117,90,45,56,33,65,65,65,65,65,35,9,11,9,10,9,9,9,16,9,9,9,9,9,9,9,12,9,9,10,9,9,9,10,10,9,9,9,9,9,9,9,106,109,106,107],
[42,79,98,99,70,56,42,42,42,42,42,42,42,79,9,9,9,9,9,9,9,9,9,9,9,9,9,9,9,9,9,9,9,9,9,9,9,9,9,9,9,9,9,9,106,108,110,110],
[42,33,35,84,97,56,42,42,42,42,42,42,42,79,109,44,59,44,45,9,9,9,9,9,16,9,28,65,65,65,65,65,65,65,65,35,9,9,11,9,9,9,10,9,9,69,111,109],
[42,42,42,33,65,53,42,42,42,42,42,42,42,79,84,108,109,106,108,109,9,12,9,9,9,28,53,42,42,42,42,42,42,42,42,42,79,9,9,9,9,9,9,9,9,68,107,106],
[42,42,42,42,42,42,42,42,42,42,42,42,42,33,65,35,95,84,85,69,20,9,9,28,65,53,42,42,42,42,42,42,42,42,42,42,79,9,9,9,12,9,9,9,9,69,110,105],
[42,42,27,91,91,91,91,91,34,42,42,42,42,42,42,42,57,103,103,21,22,121,92,83,42,42,42,42,42,42,42,42,42,42,42,42,79,9,9,9,9,9,9,9,9,110,106,111],
[42,42,79,9,9,58,45,9,54,42,42,42,42,42,42,46,58,45,9,10,23,107,60,54,42,42,42,42,42,42,42,42,42,42,42,46,9,9,9,9,9,9,11,9,9,68,110,107],
[42,42,79,9,109,69,70,9,9,91,91,34,42,42,27,9,69,70,9,9,9,9,110,45,91,91,91,91,91,91,91,55,91,91,91,9,9,9,14,9,9,9,9,9,58,111,111,18],
[42,42,79,110,108,85,97,9,11,9,9,54,42,46,9,9,110,106,60,9,9,9,109,85,9,9,10,9,9,9,9,80,9,9,9,20,9,9,9,9,9,9,9,9,109,106,108,110],
[42,42,79,110,97,9,9,9,9,9,9,9,91,9,9,9,9,85,109,9,11,9,9,9,9,9,9,9,9,10,9,101,102,92,21,22,121,92,93,9,110,60,9,10,9,84,111,107],
[42,42,79,97,9,9,9,10,9,9,9,9,9,9,9,9,10,9,9,9,9,9,9,9,9,9,9,9,9,9,9,9,9,9,9,23,9,9,94,110,85,106,45,9,9,9,95,106],
[42,42,79,13,9,9,9,9,9,9,9,13,9,9,9,9,9,9,9,9,9,9,9,9,11,9,9,9,9,13,10,9,9,11,9,9,9,28,66,67,35,95,109,9,9,9,9,111],
[42,42,79,9,9,9,9,9,9,9,9,9,9,9,10,9,9,9,10,9,11,9,9,9,9,9,9,9,12,9,9,9,9,9,9,9,109,56,42,42,42,33,35,9,12,9,10,69],
[42,42,79,9,9,9,9,12,9,9,9,9,9,9,9,9,9,9,9,9,9,9,9,9,9,10,9,9,9,9,9,9,9,9,107,85,97,56,42,42,42,42,42,79,9,9,9,68],
[42,42,79,9,9,9,9,9,9,9,9,9,9,9,9,11,9,10,9,9,9,9,9,9,9,9,9,9,10,9,9,11,9,106,111,28,65,53,42,42,42,42,42,79,11,9,43,69],
[42,42,79,9,9,9,9,9,9,9,9,14,9,9,9,9,9,9,9,9,9,9,9,9,9,9,9,9,9,9,9,9,9,110,86,56,42,42,42,42,42,42,42,79,15,9,68,109],
[42,42,79,9,11,9,9,9,9,9,9,9,9,9,9,9,9,9,9,9,12,9,9,9,9,9,9,9,9,9,9,9,9,70,28,53,42,42,42,42,42,42,42,79,9,9,110,111],
[42,42,79,9,9,10,10,9,9,9,9,9,9,9,9,9,9,9,9,9,10,9,9,9,9,9,9,9,9,11,9,9,9,9,56,42,42,42,42,42,42,42,42,79,13,9,69,108],
[42,42,79,9,9,9,9,9,9,9,9,9,11,9,9,9,9,10,9,9,9,9,9,14,9,9,9,9,9,9,9,9,14,9,56,42,42,42,42,42,42,42,42,79,9,9,95,110],
[42,42,79,9,9,9,9,9,9,9,9,9,9,9,9,9,9,9,9,9,9,9,9,9,9,9,9,9,9,10,9,9,9,9,56,42,42,42,42,42,42,42,42,79,9,11,9,69],
[42,46,59,109,9,9,9,9,9,9,13,9,9,9,9,9,9,9,9,9,9,9,9,9,9,9,9,9,9,9,9,9,9,9,56,42,42,42,42,42,42,42,42,79,9,9,9,84],
[27,107,108,70,9,9,9,9,9,9,9,9,9,9,9,10,9,9,9,9,10,9,9,9,9,9,9,9,9,9,9,9,9,11,56,42,42,42,42,42,42,42,42,79,109,9,9,9],
[79,106,110,97,9,9,11,9,9,9,9,9,9,9,9,9,9,9,9,9,9,9,9,9,9,9,13,9,9,9,9,10,9,9,56,42,42,42,42,42,42,42,42,79,108,109,10,9],
[79,110,70,9,9,9,9,9,9,9,9,9,9,9,9,9,9,9,9,9,9,9,9,9,9,9,9,12,9,9,9,9,9,9,56,42,42,42,42,42,42,42,42,79,107,70,15,9],
[79,95,108,10,9,9,9,9,9,9,10,9,9,11,9,9,9,9,9,9,9,9,9,10,9,9,9,9,9,9,9,9,9,9,56,42,42,42,42,42,42,42,42,79,106,71,9,12],
[79,9,9,9,9,9,9,9,9,9,9,9,9,9,9,9,9,9,11,9,9,9,9,9,9,9,9,9,9,9,9,11,9,9,56,42,42,42,42,42,42,42,42,79,109,111,9,9],
[79,9,9,9,13,9,9,9,9,9,9,9,9,9,9,9,14,9,9,9,9,9,9,9,9,9,9,9,9,9,9,9,9,9,54,42,42,42,42,42,42,42,42,79,108,9,11,9],
[33,35,9,9,9,10,9,9,9,9,9,9,12,9,9,9,9,9,9,9,9,9,9,9,9,9,9,10,9,9,9,9,9,43,109,91,91,34,42,42,42,42,42,79,9,9,9,43],
[42,42,79,9,9,9,9,9,9,9,9,9,9,9,9,9,9,9,9,9,9,9,9,9,10,9,9,9,9,10,9,9,9,69,70,60,9,56,42,42,42,42,42,79,10,9,9,68],
[42,42,79,9,9,9,9,9,9,9,10,9,9,9,9,9,9,10,9,9,9,10,9,9,9,9,9,9,9,10,9,9,10,95,85,69,9,56,42,42,42,42,42,79,9,9,58,110],
[42,42,79,9,9,11,9,9,9,9,9,9,9,9,9,9,9,9,9,9,9,9,9,9,9,9,9,9,9,9,9,9,9,9,9,9,9,54,42,42,42,42,46,9,9,10,69,106],
[42,42,79,9,9,9,9,10,9,9,9,9,13,9,9,11,9,9,9,9,9,9,9,10,9,9,9,9,9,10,9,9,9,11,9,9,9,9,34,42,42,27,9,9,10,9,68,108],
[42,42,79,9,9,9,9,9,9,9,9,9,9,9,9,9,9,9,9,9,9,9,9,9,9,9,9,9,9,9,10,9,9,9,9,12,9,45,54,42,42,79,10,9,9,58,106,107],
[42,42,33,65,65,35,9,9,12,9,9,9,9,9,9,9,9,10,9,10,9,9,9,9,9,9,9,11,9,9,10,9,9,9,9,9,9,9,9,91,55,9,9,9,11,109,111,109],
[42,42,42,42,42,42,79,9,9,9,9,9,9,9,9,9,9,9,9,9,9,9,9,9,9,9,9,9,9,9,9,9,9,9,9,9,9,9,11,9,122,9,9,9,9,9,84,106],
[42,42,42,42,42,42,79,9,9,9,10,9,9,9,9,9,10,9,9,9,9,9,9,9,10,9,9,9,9,9,9,9,9,11,9,10,9,9,9,24,25,26,13,9,9,12,9,95],
[42,42,42,42,42,42,79,110,9,9,9,9,14,9,9,9,9,9,9,9,9,9,13,9,9,9,9,10,9,9,9,9,9,9,9,9,10,9,9,9,123,9,9,9,9,9,9,9],
[42,42,42,42,42,42,79,109,60,9,9,9,9,9,9,9,9,9,9,9,9,9,9,9,9,9,9,9,9,9,13,9,9,9,9,9,9,9,11,28,66,67,35,9,9,10,9,10],
[27,91,91,34,42,42,33,35,109,9,9,9,9,13,9,9,9,9,9,10,9,9,9,9,28,65,35,9,106,109,111,60,9,9,9,14,9,9,9,56,42,42,42,79,9,9,9,9],
[79,43,45,54,42,42,42,42,33,35,9,9,9,9,9,9,9,9,9,43,110,109,28,65,53,42,42,33,35,84,85,106,59,9,9,9,9,9,28,53,42,42,42,79,10,9,11,9],
[79,84,110,60,34,42,42,42,42,42,33,35,9,9,9,9,9,11,109,85,97,28,53,42,42,42,42,42,42,33,35,69,108,70,28,65,65,65,53,42,42,42,42,79,9,9,9,9],
[33,35,95,97,56,42,42,42,42,42,42,42,33,65,65,65,65,65,65,65,65,53,42,42,42,42,42,42,42,42,42,79,109,9,56,42,42,42,42,42,42,42,42,79,10,9,9,43],
[42,42,33,65,53,42,42,42,42,42,42,42,42,42,42,42,42,42,42,42,42,42,42,42,42,42,42,42,42,42,42,33,65,65,53,42,42,42,42,42,42,42,42,79,9,9,43,110],
[42,42,42,42,42,42,42,42,42,42,42,42,42,42,42,42,42,42,42,42,42,42,42,42,42,42,42,42,42,42,42,42,42,42,42,42,42,42,42,42,42,42,42,79,9,58,106,107]]