[[9,9,9,9,9,9,9,9,9,9,9,9,9,9,9,9,9,9,9,9,9,9,9,9,9,9,9,9,9,9,9,9,9,9,9,9,9,9,9,9,9,9,9,9,9,11,68,110],
[9,9,9,9,9,9,9,9,9,9,9,9,9,9,9,9,9,9,9,9,9,9,9,9,9,9,9,9,9,9,9,9,9,9,9,9,9,9,9,9,9,9,9,9,9,43,111,109],
[9,9,9,9,9,9,9,9,9,9,9,9,9,9,9,9,9,9,9,9,9,9,9,9,9,9,9,9,9,9,9,9,9,9,9,9,9,9,9,9,9,9,9,9,9,109,109,108],
[9,9,9,9,9,9,9,9,9,9,9,9,9,9,9,9,9,9,9,9,9,9,9,9,9,9,9,9,9,9,9,9,9,9,9,9,9,9,9,9,9,9,9,9,9,95,109,109],
[9,9,9,9,9,9,9,9,9,9,9,9,9,9,9,9,9,9,9,9,9,9,9,9,9,9,9,9,9,9,9,9,9,9,9,9,9,9,9,9,9,9,9,9,9,9,10,110],
[9,9,9,9,9,9,9,9,9,9,9,9,9,9,9,9,9,9,9,9,9,9,9,9,9,9,9,9,9,9,9,9,9,9,9,9,9,9,9,9,9,9,9,9,9,9,105,107],
[9,9,9,9,9,9,9,9,9,9,9,9,9,9,9,9,9,9,9,9,9,9,9,9,9,9,9,9,9,9,9,9,9,9,9,9,9,9,9,9,9,9,9,9,9,15,111,108],
[10,9,13,9,9,9,12,9,9,9,9,9,9,9,9,9,9,9,9,9,9,9,9,9,9,9,9,9,9,9,9,9,9,9,9,9,9,9,9,9,9,9,9,9,9,9,109,107],
[12,11,109,105,45,14,9,15,9,9,9,9,9,9,9,9,9,9,9,9,9,9,9,9,9,9,9,9,9,9,9,9,9,9,9,9,9,9,9,9,9,9,9,9,9,9,95,109],
[110,59,105,111,115,63,108,107,11,9,9,16,9,9,9,9,9,9,9,9,9,9,9,9,9,9,11,9,9,9,9,9,9,9,9,9,9,9,15,9,9,9,9,9,9,9,16,111],
[111,106,107,110,75,76,110,105,111,13,9,13,9,9,9,9,9,9,9,9,9,13,9,9,9,9,9,9,9,9,9,9,9,16,9,9,9,9,9,9,9,9,9,9,9,9,9,107],
[103,92,93,107,107,111,108,106,105,45,15,9,118,15,9,11,9,9,9,9,9,9,9,9,13,9,9,9,9,9,9,14,9,9,9,9,14,9,9,9,9,9,10,9,9,15,9,68],
[106,110,80,111,108,11,13,14,15,105,110,10,9,9,9,9,9,9,9,9,10,9,9,9,9,9,9,9,14,9,9,9,9,9,9,109,15,105,9,9,9,9,9,9,9,9,10,109],
[108,105,100,108,11,15,10,19,11,15,13,11,15,15,9,16,118,15,9,9,9,9,9,9,9,9,9,9,9,9,9,10,9,9,16,58,106,16,9,15,9,9,9,9,108,45,105,110],
[107,106,80,110,20,16,18,17,18,107,14,105,60,59,9,9,9,9,9,120,9,9,9,9,15,9,9,9,17,9,9,120,9,9,12,105,110,14,9,9,111,12,107,16,9,110,111,108],
[110,107,101,21,22,121,103,93,107,96,11,13,105,106,10,15,13,9,9,9,9,9,120,9,111,43,44,109,12,9,9,9,9,15,107,105,107,107,9,9,107,16,90,11,12,15,109,107],
[111,107,108,106,23,18,19,80,108,44,110,10,13,11,14,105,108,11,9,9,16,9,13,9,95,108,106,70,9,9,9,15,9,69,105,105,111,108,15,9,11,106,115,63,90,111,14,110],
[105,44,69,107,9,10,17,101,93,107,105,107,106,108,44,107,111,105,15,109,9,9,9,9,108,107,106,107,106,60,9,9,45,14,107,107,106,110,9,9,109,117,90,116,64,115,63,108],
[106,107,96,108,110,9,107,111,100,107,106,106,107,68,90,111,108,70,12,71,106,9,9,9,15,84,110,110,108,106,9,9,109,58,105,107,105,14,13,10,64,98,99,77,78,75,76,9],
[107,110,111,9,11,14,107,76,80,107,81,92,93,111,96,107,107,106,105,86,97,9,11,118,9,9,106,106,110,107,9,9,13,105,106,108,108,12,9,117,115,63,11,24,106,105,9,15],
[107,108,10,12,108,107,107,111,100,106,80,107,101,93,108,111,107,108,110,9,16,9,9,9,16,9,95,106,106,109,9,12,105,110,107,110,111,9,9,109,75,76,12,13,109,105,10,107],
[108,105,15,9,9,107,107,111,101,92,104,110,110,101,92,93,110,90,105,60,14,15,9,9,119,12,9,17,18,14,15,107,107,107,111,105,13,12,15,98,116,64,14,11,115,63,14,9],
[107,107,96,107,11,108,117,90,110,10,69,107,44,111,106,101,93,111,105,105,106,109,14,9,9,9,9,19,17,18,11,105,116,115,63,107,106,10,9,107,77,78,16,10,75,76,111,9],
[107,110,107,10,9,12,98,99,108,15,115,107,108,45,107,108,101,93,10,95,110,70,9,9,9,9,15,9,107,108,105,105,77,64,76,106,105,105,9,14,75,76,117,90,64,108,9,11],
[106,106,107,107,10,13,11,15,10,13,75,116,64,107,110,111,19,80,9,11,17,12,9,9,18,14,59,105,69,107,107,106,108,78,69,108,108,105,9,95,106,109,98,99,78,109,9,9],
[107,44,107,68,105,107,111,13,107,106,110,77,78,111,13,14,17,100,16,20,9,15,20,9,81,103,93,110,107,111,96,110,44,105,106,110,107,90,105,14,9,15,12,108,111,107,9,9],
[107,105,96,107,108,110,15,14,111,107,107,69,69,86,11,111,108,101,21,22,121,21,22,121,104,108,101,93,106,90,107,116,64,107,68,107,9,11,13,9,15,9,107,14,109,15,9,13],
[111,68,106,107,69,10,9,108,110,10,110,111,13,9,14,106,110,107,110,23,23,11,23,13,58,105,105,100,111,107,117,77,78,106,110,15,9,106,15,105,12,9,9,9,12,9,9,14],
[44,69,11,106,96,107,13,9,16,9,11,15,10,107,10,110,107,105,14,9,15,9,16,12,108,107,111,80,108,108,68,99,111,108,96,110,10,14,108,117,18,13,17,9,9,9,9,105],
[116,64,44,107,108,107,110,106,111,10,9,107,110,106,105,107,111,108,107,110,16,14,9,107,105,69,110,101,92,93,111,107,106,107,107,90,106,13,110,107,17,19,76,108,86,15,14,106],
[77,78,90,115,63,110,69,107,111,106,12,111,107,108,110,108,111,107,111,12,9,9,15,115,63,106,110,107,108,80,106,110,111,106,106,108,110,9,15,11,9,111,111,105,11,10,105,110],
[110,98,99,75,76,96,107,106,9,11,9,108,107,110,111,14,15,107,11,9,13,106,11,75,76,107,107,110,111,101,92,103,92,93,110,107,11,15,107,108,10,10,107,106,110,90,108,111],
[69,106,68,69,108,16,107,10,15,12,107,108,107,107,105,97,9,9,9,110,15,105,107,117,90,110,69,108,110,108,107,106,110,101,93,108,13,107,111,13,14,69,110,108,44,110,107,108],
[107,106,14,107,107,111,44,107,10,108,105,107,111,105,86,9,15,9,15,111,69,116,64,98,99,69,96,105,106,68,69,108,69,108,100,107,106,105,10,9,110,108,96,117,107,69,110,106],
[111,105,110,44,108,106,69,106,9,106,111,110,107,16,14,16,9,10,43,107,110,77,78,69,111,106,111,108,107,69,117,90,107,81,104,107,107,106,107,14,9,111,107,44,111,108,9,12],
[68,107,111,117,90,105,111,16,11,14,108,107,15,12,9,9,14,108,105,111,107,108,69,107,13,11,9,13,110,111,98,99,111,80,111,106,110,107,18,17,13,11,10,106,106,9,105,13],
[107,107,108,98,99,64,110,69,12,10,110,111,105,9,16,106,9,105,107,106,111,69,111,15,9,111,10,12,13,110,110,19,18,101,92,103,92,93,19,68,111,9,111,68,110,13,10,15],
[96,15,111,111,107,78,106,44,111,12,9,108,15,9,11,105,11,9,10,69,107,110,14,9,10,107,110,15,110,108,15,13,17,108,108,108,110,101,93,107,108,12,13,110,107,11,9,9],
[13,12,9,9,14,69,11,107,108,105,13,10,9,16,111,107,108,16,14,106,13,9,13,108,107,105,106,9,120,14,9,10,19,69,111,115,63,111,80,110,90,111,15,9,108,111,12,14],
[9,9,9,13,9,106,110,107,111,9,15,9,9,15,106,69,69,107,9,11,15,12,117,115,63,107,9,16,13,16,14,13,11,110,116,75,76,107,80,106,111,107,110,10,107,90,110,106],
[11,9,15,9,9,11,105,12,9,14,9,14,110,105,107,96,105,107,108,107,9,107,98,75,76,110,9,14,9,12,119,13,12,13,108,78,111,110,101,92,93,106,108,9,111,107,110,108],
[9,9,9,14,9,9,13,16,9,11,105,44,111,106,69,111,110,44,105,10,14,107,107,111,13,14,13,118,11,9,13,15,13,14,13,111,108,107,17,18,122,106,10,13,10,69,111,107],
[9,14,9,9,9,15,9,9,9,108,96,110,107,107,117,90,69,106,107,111,11,13,15,110,9,12,10,13,15,12,14,12,14,118,14,12,107,14,12,24,25,26,12,9,107,107,117,110],
[13,9,15,9,16,9,11,9,16,15,9,9,106,105,98,99,64,107,107,13,9,108,9,16,13,106,9,14,16,106,13,120,16,15,9,12,13,9,10,107,123,110,106,111,68,107,106,111],
[9,10,9,9,9,9,9,9,9,9,9,9,9,10,105,106,78,110,68,16,10,111,14,9,9,12,15,117,111,111,15,13,9,11,16,14,120,13,107,107,101,103,92,93,107,76,96,107],
[9,9,9,15,9,11,9,9,9,9,9,15,16,9,15,84,109,105,97,14,68,96,108,13,107,106,110,116,64,108,13,14,13,14,105,13,10,110,106,44,107,107,111,100,108,110,107,106],
[12,9,9,9,9,9,9,14,9,9,9,9,9,14,16,9,95,9,11,9,9,15,111,11,106,107,96,77,78,106,110,13,119,13,106,108,107,44,111,117,68,96,107,101,92,103,92,103],
[9,9,9,13,9,9,9,9,9,11,9,9,9,9,9,12,9,10,14,107,15,9,12,15,110,105,108,44,106,107,111,108,13,10,12,111,110,106,96,107,69,111,76,106,85,111,12,110]]