[[111,70,106,84,109,107,68,70,44,107,105,97,10,16,106,109,107,105,107,111,60,43,59,45,105,12,14,9,9,11,9,13,9,10,9,9,85,86,9,9,9,60,9,9,80,10,95,106],
[71,70,84,70,111,85,110,15,14,12,13,60,108,107,108,111,107,111,106,105,108,70,85,10,9,11,9,9,9,9,9,11,9,9,9,9,12,9,13,9,9,70,9,9,101,102,93,86],
[44,68,109,69,13,14,12,13,70,70,10,109,9,110,95,106,111,108,111,111,105,10,9,12,109,9,9,9,12,9,9,9,9,9,9,14,9,9,9,9,9,109,9,9,9,9,101,93],
[106,105,71,110,9,70,111,71,106,44,15,11,15,9,9,84,107,105,96,97,11,9,43,71,109,10,9,9,9,9,10,9,9,13,9,9,9,9,9,9,11,9,9,110,9,9,9,80],
[68,13,14,10,15,110,44,106,20,11,12,9,9,9,14,9,95,109,12,9,13,19,69,86,70,9,12,9,9,9,9,9,9,9,9,9,9,9,9,9,9,9,15,10,9,9,9,101],
[107,9,85,111,85,68,84,97,105,70,9,14,9,9,9,15,9,13,9,106,105,106,17,10,9,11,9,9,9,9,9,9,12,9,9,11,9,9,13,9,9,9,9,9,9,9,109,111],
[70,12,10,71,107,70,106,45,111,9,9,9,9,15,9,9,9,9,9,69,107,97,11,9,15,9,9,13,9,9,9,9,9,9,108,107,9,9,9,9,9,9,9,9,13,9,12,81],
[111,110,14,105,69,69,84,107,97,9,16,9,9,9,9,9,12,9,9,85,106,10,15,9,9,9,9,9,9,9,9,9,9,10,9,9,9,11,9,10,9,9,11,9,9,9,9,100],
[71,107,13,111,68,44,108,10,11,9,9,9,9,9,9,9,9,9,109,97,68,97,9,12,9,9,9,9,9,9,9,11,9,9,9,12,9,9,9,9,12,9,9,9,14,9,9,80],
[44,43,15,12,109,108,70,108,60,14,9,9,9,9,11,9,9,9,9,15,69,110,60,9,9,9,9,9,12,9,9,9,9,14,9,9,9,9,15,9,9,9,9,9,9,9,9,100],
[106,68,107,15,111,110,108,106,107,9,9,9,9,9,9,9,9,15,9,9,9,109,70,11,9,9,9,9,9,9,9,9,9,9,9,9,13,9,9,9,9,13,9,9,9,10,108,80],
[84,69,109,10,107,106,70,15,109,109,9,16,9,9,9,12,9,10,9,11,9,12,9,9,15,9,9,10,9,9,9,10,9,9,11,9,9,9,9,13,9,9,11,9,9,9,11,100],
[111,14,10,111,107,111,108,12,15,106,9,9,9,9,9,109,105,45,9,9,15,10,18,19,9,9,9,9,9,11,9,9,9,9,9,9,9,9,9,9,9,9,9,9,9,9,9,101],
[70,12,68,107,109,108,71,14,9,9,9,9,9,11,68,110,69,107,14,9,9,17,19,11,9,9,11,9,9,9,9,9,9,9,9,9,12,9,11,9,9,9,9,9,11,9,9,105],
[109,9,69,106,85,96,97,107,9,11,9,9,9,9,10,105,12,9,15,9,10,19,18,10,9,13,17,9,9,13,9,9,10,9,9,9,9,9,9,9,9,13,9,14,9,9,9,81],
[107,13,95,97,97,97,9,15,9,9,9,9,15,9,9,13,15,105,45,15,106,86,84,58,106,9,15,12,9,9,9,15,9,9,11,9,9,9,9,9,9,9,9,9,9,9,9,100],
[70,14,107,10,20,105,9,9,9,15,9,9,9,9,9,9,108,97,107,9,14,10,13,70,97,9,14,15,105,109,9,9,9,15,9,9,14,9,9,12,9,9,9,9,9,9,9,101],
[106,15,16,15,96,109,9,11,9,9,9,9,9,9,13,9,9,12,9,12,111,113,31,32,10,9,9,13,106,70,106,9,9,9,9,9,9,15,9,9,9,9,9,110,9,9,9,13],
[86,105,108,14,9,9,9,9,9,9,9,9,9,9,9,9,10,43,106,15,10,39,40,41,43,111,14,111,105,86,9,11,9,9,10,9,9,9,9,9,14,111,85,95,106,85,108,96],
[106,71,69,15,9,16,9,9,9,9,15,9,9,11,9,14,105,70,86,13,105,50,51,52,105,9,9,106,97,9,10,9,9,9,9,9,9,9,16,9,15,84,69,111,97,15,70,109],
[70,106,97,108,9,9,10,9,9,9,9,9,9,9,19,9,95,108,9,12,9,13,58,111,106,9,69,71,15,9,9,14,105,12,9,9,11,9,9,11,9,10,85,109,9,9,95,85],
[71,59,13,9,9,105,9,9,9,16,9,9,15,9,15,9,15,10,9,9,106,10,106,9,11,10,12,107,9,12,15,44,108,19,13,9,9,9,9,9,9,9,9,15,9,14,10,105],
[108,107,15,107,13,9,9,9,9,9,9,9,9,9,9,9,9,9,13,14,9,15,12,9,9,108,60,10,11,9,14,109,97,9,9,9,9,9,9,9,15,9,9,9,9,9,11,15],
[108,105,109,86,10,9,9,108,9,9,9,9,9,13,9,16,9,15,9,9,9,9,9,9,11,109,105,14,9,9,9,9,9,15,9,9,12,9,9,11,9,9,9,9,9,9,9,28],
[15,84,86,106,15,107,45,45,9,18,9,9,9,9,15,9,9,9,9,9,9,9,9,9,9,9,9,13,9,11,13,9,9,12,9,14,9,9,9,9,9,9,9,9,16,9,9,56],
[9,105,9,15,9,15,109,10,9,9,9,106,9,9,9,9,9,109,111,12,9,9,9,9,9,9,9,9,9,9,9,9,11,105,44,109,11,9,9,9,9,9,9,13,9,9,9,56],
[9,10,9,9,9,12,96,9,108,60,10,9,11,9,9,13,9,118,9,13,14,45,10,120,9,9,13,9,9,9,9,9,9,69,109,70,9,9,9,14,9,9,9,9,9,9,9,56],
[107,9,9,12,111,9,11,9,16,111,9,43,15,15,9,9,9,15,10,9,109,106,14,15,9,9,9,9,9,9,9,11,9,109,96,108,13,9,9,9,9,9,9,9,9,9,9,56],
[84,108,9,11,9,43,106,9,10,9,12,105,110,9,15,9,9,9,43,12,9,15,9,11,14,109,9,9,15,9,9,9,14,9,12,9,14,9,9,11,9,9,9,9,9,9,9,56],
[9,9,11,9,13,114,61,62,45,13,15,9,10,15,9,9,9,13,105,111,9,107,71,15,108,97,10,9,9,9,9,13,9,9,9,9,9,9,9,9,9,9,9,15,9,9,9,56],
[105,9,9,109,11,72,73,74,109,9,10,9,85,9,9,13,9,9,9,9,9,106,14,10,9,15,9,9,9,9,9,9,9,9,11,9,9,9,12,9,9,13,9,9,9,9,9,56],
[10,9,9,43,45,87,88,89,97,108,9,9,9,11,9,9,9,9,13,9,11,9,12,109,60,12,18,11,9,9,14,9,9,9,9,13,9,9,9,9,9,9,9,9,11,9,9,56],
[9,13,9,45,106,20,111,96,10,11,9,111,9,9,14,9,15,15,9,9,9,9,14,95,106,9,9,9,9,13,9,9,9,9,9,9,9,9,9,9,9,9,9,9,9,9,9,56],
[9,9,111,9,9,9,9,11,108,60,9,10,9,13,9,9,9,9,14,9,43,108,9,9,11,9,15,108,9,17,9,9,9,9,9,9,9,12,9,9,16,9,9,120,9,9,28,53],
[9,9,9,11,9,110,9,13,20,97,11,9,9,9,12,9,9,9,9,9,119,14,9,9,9,9,9,14,10,9,9,9,11,111,70,45,9,9,9,9,9,115,63,15,9,9,56,42],
[9,120,9,9,11,9,10,9,9,106,9,9,105,9,9,9,14,9,9,9,15,9,9,9,9,9,9,9,106,9,109,105,9,10,106,10,9,44,109,13,9,75,76,10,9,9,56,42],
[9,10,9,15,9,9,9,9,9,9,9,9,14,10,9,9,9,9,9,9,9,9,14,9,9,9,84,9,15,9,15,95,107,9,15,9,108,107,106,16,14,9,10,9,9,9,56,42],
[9,9,117,90,9,14,9,16,9,9,9,14,9,9,9,9,16,9,9,9,9,9,9,9,15,9,9,9,15,106,9,13,11,15,10,15,13,84,14,9,9,9,9,11,9,11,54,42],
[120,9,98,99,9,9,118,9,9,9,9,9,9,9,14,9,9,9,20,9,14,9,9,9,9,9,58,111,70,118,9,112,29,30,9,111,9,15,11,9,12,9,11,9,9,15,9,56],
[10,14,10,11,9,16,9,9,14,9,15,9,9,9,9,9,13,9,9,9,9,14,9,9,9,9,9,9,14,107,59,36,37,38,10,11,10,106,15,107,9,9,9,9,9,9,16,56],
[9,116,64,15,9,9,15,115,63,20,9,9,10,118,14,9,9,9,9,11,9,9,9,16,9,9,9,11,9,69,119,47,48,49,9,15,111,107,105,109,10,9,13,9,15,10,9,56],
[15,77,78,9,9,15,9,75,76,14,9,117,90,14,14,9,9,9,10,9,14,23,9,9,14,9,9,15,106,15,9,107,10,109,106,9,16,9,11,9,9,9,9,9,9,11,14,56],
[9,14,9,11,20,9,15,10,14,9,10,98,99,10,9,15,9,14,105,9,28,65,35,120,9,15,9,10,9,10,105,9,11,15,9,95,9,59,15,9,9,11,9,9,28,65,65,53],
[9,9,15,115,63,20,9,9,9,10,28,65,35,15,9,9,9,43,59,109,56,42,42,65,65,65,35,9,9,110,14,70,106,9,11,9,16,11,9,9,9,58,60,9,56,42,42,42],
[9,14,10,75,76,14,10,14,9,120,56,42,42,79,11,9,106,68,108,70,56,42,42,42,42,42,79,9,95,97,9,105,10,9,9,9,84,9,9,10,9,68,107,111,56,42,42,42],
[9,9,9,15,14,9,116,64,28,65,53,42,42,79,9,9,84,95,96,97,56,42,27,91,91,34,79,106,9,9,9,9,9,95,97,12,9,9,9,9,9,110,28,65,53,42,42,42],
[9,9,13,9,9,14,77,78,56,42,27,34,42,79,119,14,9,28,65,65,53,42,58,108,45,56,33,65,35,9,9,13,28,65,65,65,35,105,9,13,9,84,56,42,42,42,42,42],
[16,9,9,9,15,9,15,14,56,42,33,53,42,33,35,105,16,56,42,42,42,42,68,111,70,56,42,42,42,65,65,65,53,42,42,42,42,65,65,65,65,65,53,42,42,42,42,42]]