[[131,113,116,112,9,118,9,113,70,112,116,112,9,9,9,9,9,9,9,9,116,110,113,112,110,120,114,112,70,115,116,11,9,9,9,9,9,9,15,9,9,112,9,111,9,133,116,110],
[9,9,9,9,9,115,9,9,9,113,132,9,9,70,132,9,9,9,14,9,112,115,59,60,119,112,112,116,108,112,111,111,9,9,9,112,133,9,113,9,9,115,113,131,9,9,9,115],
[9,9,9,9,9,9,9,13,9,9,9,9,113,108,112,9,9,9,113,9,109,112,62,61,112,116,109,111,9,109,113,133,9,9,9,113,111,9,9,9,9,9,9,9,9,9,9,111],
[9,9,9,9,9,133,115,111,9,9,9,116,115,116,113,9,9,9,116,9,115,110,112,115,116,112,115,112,70,113,115,9,9,9,9,109,112,116,112,70,112,9,116,113,115,123,112,112],
[9,9,9,9,9,109,110,113,9,9,9,115,111,119,112,116,108,115,112,9,120,112,119,112,115,9,9,112,116,112,116,9,112,132,9,13,108,133,9,9,9,9,9,9,133,112,116,115],
[115,9,9,9,15,113,70,112,9,9,9,113,116,112,113,9,9,9,9,9,9,116,112,113,112,9,9,116,112,115,9,9,113,116,9,9,9,9,9,17,9,9,131,9,9,9,109,122],
[118,112,16,9,9,9,112,115,112,113,116,115,133,9,9,9,116,113,112,9,9,9,9,112,110,9,9,9,17,9,9,116,116,115,112,113,112,9,9,9,9,9,9,9,9,9,116,112],
[116,108,112,14,17,9,9,112,116,124,9,9,9,9,113,132,112,11,111,116,9,9,9,9,9,9,123,9,9,9,115,118,112,111,9,112,9,132,9,9,9,133,124,9,132,9,113,116],
[111,9,9,113,116,14,9,9,9,9,9,123,115,113,116,112,108,112,116,112,9,9,9,132,70,113,112,115,112,70,112,113,115,108,112,113,9,9,131,9,9,9,9,9,9,9,123,113],
[131,9,9,15,9,9,9,119,113,122,112,113,112,108,112,111,131,109,112,113,112,115,9,115,112,110,116,114,117,112,112,110,112,9,9,116,115,9,9,9,131,123,9,9,9,9,112,115],
[9,9,9,9,9,133,9,115,116,112,111,9,9,9,9,113,70,113,9,9,109,111,9,131,116,115,112,111,109,112,115,112,113,9,9,109,112,116,131,9,9,9,9,9,124,116,112,118],
[116,118,112,115,116,113,9,9,112,118,115,9,9,9,9,115,112,116,9,9,116,113,9,9,9,9,109,118,87,113,111,9,9,9,9,112,120,112,9,9,133,9,14,9,9,9,9,112],
[41,112,59,18,60,112,9,9,109,113,116,124,9,9,9,112,115,9,9,9,9,131,9,9,9,9,118,113,116,112,116,9,132,9,9,116,70,113,9,9,9,9,9,9,9,9,9,116],
[112,113,58,10,48,9,9,9,112,115,112,9,9,115,112,113,116,9,115,15,9,9,9,9,9,9,133,108,115,9,9,9,115,9,9,109,115,112,9,9,9,15,9,9,9,9,9,115],
[109,59,34,10,35,18,60,9,9,116,113,9,9,9,9,9,9,9,9,112,132,9,9,9,9,9,9,9,9,9,9,119,112,14,113,115,112,114,9,9,113,9,131,9,133,112,115,120],
[113,58,10,10,10,10,48,11,9,9,131,9,9,9,116,9,9,9,112,113,116,9,9,9,132,116,115,112,9,9,119,116,59,18,18,60,112,116,9,9,9,9,9,9,109,113,11,119],
[124,58,10,10,10,10,48,116,113,9,9,9,9,9,111,9,9,9,116,112,113,112,9,115,112,9,9,112,9,9,112,115,58,10,10,35,18,18,60,115,116,9,112,115,116,112,116,112],
[115,58,36,63,63,63,61,115,112,13,115,9,133,113,112,9,9,9,112,120,110,115,9,9,9,9,9,109,113,115,116,59,34,10,10,10,10,36,61,116,133,9,109,118,114,117,112,115],
[116,62,61,9,113,108,112,116,9,9,9,9,112,110,120,115,112,112,115,70,70,112,9,116,9,9,9,116,123,115,113,58,36,63,63,63,63,61,112,9,9,9,132,113,118,119,117,112],
[113,112,110,9,9,9,9,113,9,9,9,9,113,11,119,116,113,110,112,118,115,111,9,113,115,110,112,108,113,112,59,34,48,115,112,116,112,115,112,9,9,9,9,112,108,112,116,113],
[121,115,112,113,9,123,9,132,9,9,9,9,9,116,112,113,112,119,11,109,108,116,9,9,116,108,115,9,9,116,58,10,48,116,115,113,116,112,115,112,132,9,9,9,9,9,9,118],
[112,42,116,9,9,115,9,9,9,9,9,9,9,9,9,115,110,120,110,112,70,115,9,9,9,9,9,9,9,112,62,63,61,112,113,9,9,9,116,115,111,9,9,9,9,9,9,115],
[120,108,133,9,113,116,9,9,9,9,9,9,9,9,9,112,115,113,115,112,113,116,9,9,9,9,9,9,9,113,133,9,9,109,116,9,9,9,114,113,116,9,9,9,9,9,9,111],
[9,9,9,9,118,112,9,9,9,9,9,9,9,9,9,116,113,9,9,113,112,132,9,9,9,9,9,9,9,9,9,9,9,131,133,9,9,9,132,116,131,9,9,9,9,9,9,112],
[9,9,9,9,113,116,9,9,9,9,9,9,113,70,114,115,116,9,9,9,9,9,9,9,9,9,9,9,9,124,9,9,9,9,9,9,9,9,9,9,9,9,9,115,113,112,116,120],
[9,9,9,9,112,114,115,112,132,9,116,116,112,115,112,113,111,9,9,115,132,9,9,9,133,116,115,113,112,113,131,9,9,9,9,9,131,113,9,116,15,9,112,114,9,115,11,109],
[119,113,13,9,116,113,9,9,115,116,118,112,127,83,84,116,112,112,115,108,116,9,9,9,115,9,9,112,116,9,9,9,9,132,112,116,112,9,9,115,9,9,113,116,116,118,112,116],
[122,116,9,9,109,9,9,9,9,9,113,115,90,91,92,113,120,113,111,9,109,115,9,113,112,9,9,109,113,9,9,9,123,112,114,113,115,9,9,113,9,9,9,116,113,126,103,113],
[112,113,9,9,112,9,9,9,9,9,9,112,96,97,98,11,116,110,116,87,115,111,9,9,9,9,9,115,112,116,115,9,9,116,118,9,112,113,114,112,9,9,9,109,116,106,107,112],
[115,110,9,9,115,9,9,132,9,9,9,116,112,113,116,113,115,112,108,113,112,116,9,116,9,9,112,114,113,112,113,116,9,112,116,112,116,112,113,111,9,9,9,113,112,115,112,115],
[120,116,113,9,113,116,115,123,9,132,108,112,118,112,112,112,9,9,9,9,9,9,9,132,113,108,115,112,115,113,108,131,9,115,9,9,9,9,115,112,9,124,9,9,120,113,109,111],
[9,9,9,9,9,9,9,9,9,9,9,112,113,121,122,116,9,9,9,9,9,9,9,9,9,9,9,9,9,9,9,9,9,116,9,9,9,9,112,114,113,116,115,9,9,120,113,112],
[9,70,115,70,116,9,9,9,112,17,9,115,112,41,42,112,9,9,9,9,9,9,9,125,102,116,17,9,9,9,116,17,9,113,132,9,112,115,113,116,112,115,112,13,9,9,9,114],
[9,116,110,131,113,9,9,9,113,111,9,113,116,115,116,132,9,9,9,9,9,9,9,104,105,113,9,9,9,9,115,112,9,9,115,9,116,108,133,9,9,9,111,9,9,9,9,113],
[9,113,133,119,115,9,9,9,112,116,9,9,9,9,9,9,9,9,9,9,9,9,9,113,112,112,9,131,115,112,113,115,9,9,9,9,9,9,9,9,123,9,14,9,132,115,115,112],
[9,9,132,116,112,115,112,112,110,115,9,116,115,113,9,9,9,112,116,115,131,9,132,115,116,9,9,113,112,9,9,112,113,116,9,132,115,9,9,9,9,9,9,9,118,112,120,116],
[70,9,9,9,113,112,113,115,112,113,9,113,123,112,14,112,115,112,112,112,108,9,116,9,111,9,112,116,115,9,9,9,110,115,9,112,113,9,9,9,9,132,115,112,113,11,115,111],
[115,113,131,9,109,126,103,112,9,9,9,116,115,59,60,115,116,112,59,18,18,60,112,115,116,9,9,9,125,116,9,115,108,112,9,121,112,9,9,9,9,116,113,112,130,39,40,115],
[9,9,111,9,116,106,107,116,9,9,9,115,112,58,35,18,18,18,34,10,36,61,116,113,9,9,115,9,115,112,9,9,9,9,9,112,113,115,113,112,9,112,107,115,52,53,54,116],
[9,9,112,9,109,112,115,9,9,9,9,118,116,58,10,10,36,63,63,33,48,110,120,112,9,9,112,9,132,113,112,70,116,132,9,132,112,111,120,111,9,113,112,112,67,68,69,113],
[9,9,9,9,131,113,113,9,112,9,115,113,111,58,10,10,48,116,115,58,48,112,119,116,9,9,9,9,9,9,115,112,113,112,9,9,124,113,112,115,9,109,112,124,116,112,115,112],
[116,115,133,9,9,108,110,9,116,9,132,116,113,62,63,63,61,113,112,62,61,116,112,112,9,132,112,9,123,9,131,129,37,38,113,9,9,112,110,112,9,112,116,112,111,109,112,123],
[112,118,116,113,9,9,9,9,124,9,9,115,121,9,112,115,112,112,116,115,112,108,115,133,9,112,17,9,9,9,9,49,50,51,112,116,9,9,9,113,9,9,9,9,112,115,112,113],
[109,112,115,112,113,115,9,9,112,133,9,131,132,9,120,116,112,9,9,9,9,9,9,9,9,116,116,131,9,9,9,64,65,66,9,113,112,115,9,9,9,9,9,9,9,9,118,115],
[112,113,128,85,86,111,9,9,115,112,9,9,9,9,9,132,115,9,116,132,9,9,113,9,9,109,132,124,9,9,9,9,116,115,113,127,83,84,131,112,131,9,133,9,9,9,109,112],
[116,112,93,94,95,112,70,112,110,120,115,132,9,9,9,9,9,9,109,116,9,9,116,9,9,112,133,116,108,131,9,14,9,112,116,90,91,92,112,123,132,9,131,9,9,116,112,116],
[109,110,99,100,101,115,112,122,11,9,118,112,9,9,133,70,115,113,123,112,113,115,113,115,112,131,116,9,9,9,9,9,9,9,115,96,97,98,116,131,9,9,9,9,9,113,125,115],
[113,116,115,114,112,113,116,112,115,112,108,115,113,114,115,112,108,115,112,115,108,116,113,124,115,116,131,70,116,112,70,115,11,9,9,9,9,9,9,9,9,119,70,113,108,116,115,114]]