[[9,9,9,9,9,9,9,120,119,119,119,140,38,119,140,119,119,119,120,9,9,11,9,9,9,9,120,119,140,140,140,140,119,140,119,119,9,9,9,9,9,9,120,119,119,140,140,140],
[9,11,9,9,9,9,120,9,9,120,119,140,51,140,119,119,119,120,9,9,10,9,9,9,9,9,9,120,9,119,119,140,140,120,119,120,9,9,10,9,13,9,9,120,9,119,140,119],
[9,9,9,9,10,9,9,9,9,9,9,119,20,119,120,9,9,9,9,10,9,9,9,13,9,9,120,9,9,120,119,120,120,9,120,9,9,9,11,9,9,9,9,9,9,120,119,140],
[9,9,9,9,11,9,10,9,9,9,9,21,22,23,9,9,10,9,9,9,9,9,9,9,9,9,9,9,9,9,9,120,9,9,9,9,9,10,9,10,10,9,9,9,9,119,140,140],
[9,9,9,10,9,9,9,9,9,9,9,9,24,9,35,9,10,9,9,70,71,9,9,9,9,9,10,9,9,9,9,9,9,9,9,10,10,10,11,9,9,9,11,9,9,9,119,119],
[11,9,9,10,9,9,10,9,13,9,9,9,38,13,9,9,11,9,9,81,82,95,96,9,9,11,10,10,11,10,9,9,9,9,9,9,9,9,9,9,9,9,10,9,9,9,120,119],
[9,11,9,9,9,9,9,9,9,9,9,9,55,9,9,9,9,9,9,9,9,104,105,9,9,9,9,9,9,9,9,11,11,9,10,9,9,9,9,9,13,9,9,9,9,120,9,120],
[9,9,10,9,9,9,9,130,131,133,100,101,51,9,63,50,54,64,9,10,9,9,130,132,131,133,132,133,100,101,9,9,10,9,9,9,11,9,9,35,9,9,9,9,9,9,9,9],
[9,9,9,11,10,9,119,135,12,12,59,60,62,50,65,9,9,51,9,9,9,9,135,12,12,12,12,12,75,76,9,9,9,9,9,11,11,9,9,9,9,9,10,9,9,9,9,9],
[11,9,9,10,9,119,35,136,12,12,12,12,133,132,131,100,101,38,9,9,9,9,136,12,12,12,12,12,87,88,9,9,130,133,132,100,101,9,9,9,9,10,9,11,9,9,9,119],
[9,10,9,9,120,120,140,135,12,12,12,12,28,29,77,108,109,51,9,9,9,9,135,12,12,12,12,12,59,60,9,9,125,12,12,75,76,9,9,10,10,9,9,9,10,9,119,140],
[9,9,9,120,119,140,119,125,12,12,12,12,40,41,89,114,115,51,9,10,9,11,80,77,78,33,12,12,12,12,133,126,127,12,12,98,99,9,9,10,9,9,9,9,9,120,119,119],
[9,9,11,120,119,130,126,127,12,31,32,77,108,109,63,54,39,65,9,9,9,9,92,89,90,45,12,12,12,12,12,12,12,12,12,87,88,9,9,9,9,9,9,9,9,9,119,140],
[9,9,10,10,120,136,12,12,12,43,44,89,114,115,51,9,9,9,9,9,10,9,9,9,9,9,80,78,79,77,33,12,12,12,12,57,58,9,9,9,9,10,10,11,9,9,9,119],
[9,9,9,10,9,135,12,12,12,75,76,9,9,9,53,9,9,9,10,11,9,10,9,9,9,9,92,90,91,89,45,12,12,12,12,12,12,100,101,9,9,10,9,10,9,13,9,120],
[11,9,9,10,9,136,12,12,12,87,88,9,10,9,38,9,9,9,9,9,9,11,9,9,9,9,9,9,9,9,9,80,77,78,33,12,12,75,76,9,9,9,10,9,9,9,9,9],
[9,9,9,9,9,134,12,12,12,98,99,9,10,9,51,9,9,9,9,9,9,11,9,9,9,9,9,9,9,9,9,92,89,90,45,12,12,87,88,9,9,9,9,11,9,9,9,10],
[9,9,13,9,9,136,12,12,12,75,76,9,9,9,55,9,9,9,10,9,9,10,9,11,11,10,10,9,9,9,9,9,9,9,9,135,12,75,76,9,10,9,9,10,9,10,9,9],
[9,9,9,9,10,135,12,12,12,87,88,9,9,9,38,9,9,9,10,11,9,9,9,9,9,9,9,11,9,10,9,9,9,9,9,136,12,87,88,9,9,11,9,9,10,9,9,9],
[9,9,9,9,10,80,33,12,12,98,99,9,9,9,51,9,9,9,10,9,9,9,9,9,9,9,9,11,9,9,9,10,10,9,9,80,77,108,109,9,9,11,9,9,9,9,9,9],
[11,10,9,9,10,92,45,12,12,87,88,9,9,9,26,9,9,9,9,9,9,9,120,119,9,9,9,9,9,9,9,9,10,9,9,92,89,114,115,9,9,9,9,9,9,120,9,120],
[9,10,9,138,9,10,9,80,79,108,109,9,9,9,9,9,10,9,9,9,9,120,140,119,119,9,10,9,10,10,9,9,9,9,9,9,9,9,9,35,10,9,9,9,120,119,9,119],
[9,9,139,9,9,9,9,92,91,114,115,9,10,9,9,9,9,9,9,9,9,119,118,34,120,9,9,9,9,9,9,11,9,9,9,128,74,9,13,9,10,9,9,120,119,140,119,119],
[9,9,9,137,9,9,9,9,9,9,9,9,9,9,9,9,9,9,9,9,9,119,46,47,119,9,9,9,9,9,9,9,9,9,9,85,86,9,9,9,9,10,9,120,119,140,140,119],
[9,9,9,130,131,131,133,131,132,100,101,9,9,9,9,9,9,9,9,10,9,9,140,120,9,9,9,9,9,9,11,9,10,9,9,9,9,9,9,9,9,10,9,9,120,119,119,140],
[10,11,9,136,12,12,12,12,12,87,88,9,10,9,14,9,10,9,9,11,9,9,9,9,9,9,9,9,9,9,9,9,9,9,130,132,132,132,100,101,9,11,9,9,9,9,140,140],
[9,10,9,135,12,12,12,12,12,75,76,9,10,9,51,9,9,9,9,9,9,9,9,9,9,9,11,10,9,10,10,9,9,9,135,12,12,12,59,60,9,9,10,9,9,120,140,119],
[9,10,9,136,12,12,31,32,77,108,109,9,11,9,38,9,9,9,9,9,10,9,9,9,9,9,9,10,9,9,9,9,9,9,135,12,12,12,12,12,100,101,10,9,9,120,119,140],
[9,11,9,134,12,12,43,44,89,114,115,9,9,9,55,9,9,9,9,9,9,9,9,9,9,9,9,10,11,9,9,9,9,9,136,12,12,12,12,12,75,76,9,10,9,9,120,119],
[9,9,9,80,79,78,108,109,9,10,9,10,9,9,38,9,9,9,10,9,9,9,9,9,9,9,11,11,9,9,9,9,9,9,135,12,12,12,12,12,87,88,9,10,11,9,9,119],
[9,10,9,92,91,90,114,115,9,9,9,9,9,9,62,64,9,9,9,9,9,9,10,9,9,10,10,11,9,9,9,9,9,9,134,12,12,12,12,12,98,99,9,10,9,9,9,120],
[35,9,9,9,9,9,9,9,10,11,9,9,9,9,9,51,9,9,9,9,9,9,9,9,9,9,9,9,10,10,9,9,9,9,125,12,31,32,79,78,108,109,9,9,9,9,9,10],
[9,10,9,9,9,9,11,9,10,9,9,130,132,100,101,38,9,9,9,9,9,9,9,9,9,9,9,9,9,11,9,130,131,126,127,12,43,44,91,90,114,115,10,9,9,10,10,9],
[10,10,9,9,9,9,10,9,9,9,9,122,124,87,88,55,9,63,50,54,25,9,9,9,9,9,9,9,9,10,9,136,12,12,12,12,75,76,9,9,9,9,9,11,10,9,9,9],
[10,9,11,9,9,9,9,130,131,132,123,124,124,59,60,62,54,65,9,9,9,9,9,9,9,130,100,101,9,11,9,135,12,12,12,12,87,88,9,13,10,9,9,9,9,9,9,13],
[9,130,131,132,100,101,9,136,12,12,12,12,124,12,12,132,133,132,100,101,9,10,9,9,9,134,98,99,9,9,10,134,12,12,12,12,87,88,9,35,9,9,9,9,9,15,9,9],
[11,136,12,12,59,60,9,125,12,12,12,12,12,12,12,12,12,12,98,99,9,9,129,97,9,136,75,76,9,9,9,80,78,33,12,12,98,99,9,11,9,10,63,50,16,17,18,50],
[9,136,12,12,12,12,126,127,12,12,12,12,12,12,12,12,12,12,75,76,9,9,106,107,9,135,59,60,9,9,9,92,90,45,12,12,75,76,9,11,9,9,55,61,9,19,9,9],
[9,80,78,79,77,77,78,79,77,78,77,79,78,30,12,12,12,12,87,88,9,10,9,9,9,136,12,12,100,101,9,10,9,9,80,78,108,109,9,10,9,9,20,9,9,9,9,9],
[9,92,90,91,89,89,90,91,89,90,89,91,90,42,12,12,12,12,98,99,9,9,9,9,9,134,12,12,87,88,9,11,9,9,92,90,114,115,9,9,9,21,22,23,11,9,9,10],
[9,9,9,9,9,9,9,10,9,13,9,9,9,9,80,78,77,79,108,109,9,9,10,9,9,80,79,77,108,109,9,9,9,10,9,9,9,9,11,10,9,9,24,10,9,9,9,9],
[119,9,9,9,9,9,9,9,9,9,9,9,9,9,92,90,89,91,114,115,9,9,9,9,9,92,91,89,114,115,9,9,13,9,9,9,9,9,9,9,9,9,38,10,9,9,9,9],
[119,120,9,120,9,9,9,9,9,9,9,9,9,9,9,9,9,9,9,9,139,9,137,9,9,139,9,9,9,9,9,9,9,9,27,50,37,50,54,37,37,54,65,9,10,9,11,9],
[119,119,120,9,9,9,9,10,9,9,9,10,9,9,9,13,9,9,9,9,9,138,9,10,9,9,9,9,9,9,10,9,10,9,9,9,9,9,10,9,9,9,9,9,10,9,9,9],
[140,119,119,119,120,9,9,9,9,9,9,9,9,9,9,9,11,11,9,9,10,9,9,116,9,9,117,9,11,9,9,9,9,9,9,9,9,9,11,9,9,9,11,9,9,9,9,9],
[140,140,140,119,119,120,9,9,9,120,9,9,10,9,9,11,9,9,9,11,9,9,9,9,9,9,9,9,9,10,9,9,9,120,119,119,120,9,9,9,10,9,9,9,13,9,9,9],
[140,119,140,119,119,119,119,119,120,9,9,9,9,9,9,9,10,9,9,9,10,10,9,9,9,9,9,10,9,9,9,9,120,119,140,140,119,120,9,120,9,9,10,9,9,9,10,9],
[119,140,140,119,140,140,119,119,119,120,9,120,9,9,9,9,9,9,9,9,9,9,9,9,11,10,9,10,9,9,120,119,140,140,140,119,140,119,120,9,9,9,9,9,11,9,10,9]]