[[9,9,9,9,9,9,9,9,9,36,9,9,9,135,12,12,12,12,12,12,12,75,76,9,9,9,9,9,135,12,12,12,12,12,12,12,12,75,76,9,9,9,9,9,9,135,12,12],
[9,9,9,9,9,9,9,9,9,62,39,64,9,135,12,12,12,12,12,12,12,75,76,9,9,9,9,9,135,12,12,12,12,28,29,78,78,108,109,9,9,9,35,9,9,135,12,12],
[9,9,9,70,71,9,9,9,93,94,9,62,64,135,12,12,12,12,12,12,12,75,76,35,9,9,9,9,135,12,12,12,12,40,41,90,90,114,115,9,9,9,9,9,9,135,12,12],
[9,119,9,81,82,72,73,9,102,103,9,9,36,135,12,12,12,12,12,12,12,75,76,9,9,9,9,9,135,12,12,12,12,87,88,9,9,9,9,9,9,9,9,9,9,135,12,12],
[9,35,9,9,9,83,84,9,9,9,9,9,36,80,78,78,78,78,78,78,78,108,109,9,9,9,9,9,135,12,12,12,12,87,88,9,9,9,9,9,9,9,9,9,9,135,12,12],
[9,9,9,9,35,9,9,120,9,9,9,9,20,92,90,90,90,90,90,90,90,114,115,9,9,9,9,9,135,12,12,12,12,87,88,9,9,9,9,9,9,9,9,9,9,125,12,12],
[9,9,9,9,9,9,9,9,9,9,9,21,22,23,9,9,35,9,9,9,9,9,9,9,9,9,9,9,135,12,12,12,12,87,88,9,9,9,9,9,130,133,133,133,126,127,12,12],
[9,9,9,9,9,9,9,9,9,9,9,9,24,130,133,133,133,133,133,133,133,133,133,133,100,101,9,9,80,78,78,78,78,108,109,9,9,9,9,9,135,12,12,12,12,12,12,12],
[9,9,9,9,9,9,9,9,9,9,9,9,36,136,12,12,12,12,12,12,12,12,12,12,87,88,9,9,92,90,90,90,90,114,115,9,35,9,9,9,125,12,12,12,12,12,12,12],
[9,9,9,9,9,9,9,9,9,9,9,9,36,80,33,12,12,12,12,12,12,12,12,12,87,88,9,9,9,9,9,9,9,9,9,9,9,9,130,126,127,12,12,12,12,12,12,12],
[9,9,9,9,9,9,9,9,9,9,9,9,36,92,45,12,12,12,12,12,12,12,28,29,108,109,9,9,9,9,9,9,9,9,9,9,9,9,136,12,12,12,12,12,12,12,12,12],
[9,9,9,9,9,9,9,9,9,9,9,9,62,64,9,135,12,12,12,12,12,12,40,41,114,115,9,9,9,9,9,9,9,9,9,9,9,9,136,12,12,12,12,12,12,12,12,12],
[9,9,9,9,9,9,9,9,9,9,9,9,9,36,9,135,12,12,12,12,12,12,87,88,9,9,9,9,9,9,9,9,9,9,9,9,9,9,122,12,12,12,12,12,12,12,12,12],
[9,9,9,9,9,9,9,9,9,9,9,9,9,36,9,135,12,12,12,12,12,12,87,88,9,9,9,9,35,9,9,9,9,9,9,130,132,123,124,12,12,12,12,12,12,12,12,12],
[9,9,9,9,9,9,9,9,9,9,9,9,9,36,9,135,12,12,12,12,12,12,87,88,9,9,9,9,9,9,9,9,9,9,9,122,12,12,12,12,12,12,12,12,12,12,12,12],
[9,9,9,9,9,9,9,9,9,9,9,9,9,36,9,135,12,12,12,12,12,12,57,58,9,9,9,9,9,9,9,9,9,130,123,124,12,12,12,12,12,12,12,12,12,12,12,12],
[9,9,9,9,9,9,9,9,9,9,9,9,9,36,9,80,79,79,79,79,33,12,12,12,132,132,132,100,101,9,9,9,9,136,12,12,12,12,12,12,12,12,31,32,77,77,77,77],
[9,9,9,9,9,9,9,9,9,9,9,9,9,36,9,92,91,91,91,91,45,12,12,12,12,12,12,59,60,9,9,9,9,136,12,12,12,12,12,12,12,12,43,44,89,89,89,89],
[9,9,9,9,9,9,9,9,9,9,9,9,9,62,52,52,52,52,52,64,9,136,12,12,12,12,12,12,12,100,101,9,9,136,12,12,12,12,12,12,28,29,108,109,9,9,9,9],
[9,9,9,9,9,9,9,9,9,35,9,9,9,9,130,132,132,100,101,36,9,136,12,12,12,12,12,12,12,75,76,9,9,136,12,12,12,12,12,12,40,41,114,115,9,9,9,9],
[9,9,9,9,9,9,9,9,9,9,9,9,9,9,136,12,12,75,76,36,9,136,12,12,12,12,12,12,12,75,76,9,9,80,78,78,79,79,79,79,108,109,9,9,9,9,35,9],
[9,9,9,9,9,9,9,9,9,9,9,9,9,9,136,12,12,75,76,36,9,135,12,12,12,12,12,12,12,75,76,9,9,92,90,90,91,91,91,91,114,115,9,61,9,9,9,9],
[9,9,9,13,9,9,9,9,9,9,9,9,9,9,136,12,12,75,76,36,9,135,12,12,12,12,12,12,12,75,76,9,9,9,9,9,9,9,9,9,9,9,9,9,9,9,9,9],
[9,9,9,9,9,9,9,9,9,9,9,9,9,9,136,12,12,75,76,36,9,135,12,12,12,12,12,12,12,75,76,9,9,9,9,9,9,9,9,9,9,9,9,9,9,9,9,9],
[9,9,9,9,9,9,9,9,9,9,9,9,9,9,136,12,12,75,76,36,9,135,12,12,12,12,12,12,12,75,76,9,9,130,132,132,132,132,132,132,132,100,101,9,9,9,9,9],
[9,9,9,9,9,9,9,9,9,9,9,9,9,9,80,78,78,108,109,36,9,80,77,77,79,79,79,79,79,108,109,9,9,135,12,12,12,12,12,12,12,75,76,35,9,9,9,9],
[9,9,9,9,9,9,9,9,9,9,9,9,9,48,92,90,90,114,115,20,9,92,89,89,91,91,91,91,91,114,115,9,9,135,12,12,12,12,12,12,12,75,76,9,9,9,9,9],
[9,9,9,9,9,9,9,9,9,9,9,9,9,9,9,9,9,9,21,22,23,9,9,9,9,9,9,9,9,13,9,9,9,80,33,12,12,12,12,12,12,75,76,9,9,9,9,9],
[9,9,9,9,9,9,9,13,9,9,9,9,9,9,9,9,9,9,9,24,9,9,9,9,9,9,9,9,9,9,9,9,9,92,45,12,12,12,12,12,12,75,76,9,9,9,9,9],
[9,9,9,9,9,9,9,9,9,9,9,9,9,9,9,9,9,9,9,62,52,52,52,52,64,13,9,9,9,9,9,9,9,9,9,136,12,12,12,12,12,57,58,9,9,9,9,9],
[9,9,9,9,9,9,9,9,9,9,9,9,9,9,9,9,9,9,9,9,9,9,9,9,49,130,131,131,131,100,101,9,9,9,9,136,12,12,12,12,12,12,12,132,132,132,132,132],
[9,9,9,9,9,9,9,9,9,9,9,9,9,9,9,9,9,9,9,9,9,9,63,37,65,125,12,12,12,87,88,9,9,9,9,80,79,79,79,33,12,12,12,12,12,12,12,12],
[9,9,9,9,9,9,9,9,9,9,9,9,9,9,9,9,9,9,9,9,9,9,53,130,126,127,12,12,12,87,88,9,9,9,9,92,91,91,91,45,12,12,12,12,12,12,12,12],
[9,9,9,9,9,9,9,9,9,9,9,9,9,9,9,130,133,133,133,133,100,101,53,136,12,12,12,12,12,87,88,9,9,9,9,9,9,9,9,9,135,12,12,12,12,12,12,12],
[9,9,9,9,9,9,9,13,9,9,9,9,9,9,9,135,12,12,12,12,75,76,53,136,12,12,12,12,12,59,60,9,9,9,9,9,9,9,9,9,135,12,12,12,12,12,12,12],
[9,9,9,9,9,9,9,9,9,9,9,9,9,9,9,135,12,12,12,12,75,76,53,136,12,12,12,12,12,12,12,132,132,132,133,133,100,101,9,9,135,12,12,12,12,12,12,12],
[9,9,9,9,9,9,9,9,9,9,9,9,9,9,9,135,12,12,12,12,75,76,53,136,12,12,12,12,12,12,12,12,12,12,12,12,75,76,9,9,135,12,12,12,12,12,12,12],
[9,9,9,9,9,9,9,9,9,9,9,9,9,9,9,135,12,12,12,12,75,76,53,136,12,12,12,12,12,12,12,12,12,12,12,12,75,76,9,9,135,12,12,12,12,12,12,12],
[9,9,9,9,9,9,9,9,9,9,9,9,9,9,9,135,12,12,12,12,75,76,53,135,12,12,12,12,12,12,12,12,12,12,12,12,75,76,9,9,135,12,12,12,12,12,12,12],
[9,9,9,9,9,9,9,9,9,9,9,9,9,9,9,135,12,12,12,12,75,76,53,135,12,12,12,12,12,12,31,32,79,79,79,79,108,109,9,9,135,12,12,12,12,12,12,12],
[9,9,9,9,9,9,9,9,9,9,9,9,9,9,9,122,12,12,31,32,108,109,53,135,12,12,12,12,12,12,43,44,91,91,91,91,114,115,9,9,135,12,12,12,12,12,12,12],
[9,9,9,9,9,9,9,9,9,9,9,130,132,132,123,124,12,12,43,44,114,115,53,135,12,12,12,12,12,12,87,88,9,9,9,9,9,13,9,9,80,33,12,12,12,12,12,12],
[9,9,9,9,9,9,9,9,9,9,9,122,12,12,12,12,12,12,87,88,63,39,65,122,12,12,12,12,12,12,87,88,9,9,9,9,9,9,9,9,92,45,12,12,12,12,12,12],
[9,9,9,9,9,9,9,9,9,130,123,124,12,12,12,12,12,12,87,88,53,130,123,124,12,12,12,12,12,12,87,88,9,9,13,9,9,9,9,9,9,9,80,30,12,12,12,12],
[9,9,9,9,9,9,9,9,9,136,12,12,12,12,12,12,28,29,108,109,53,135,12,12,12,12,12,12,12,12,87,88,9,9,9,9,9,9,9,9,9,9,92,42,12,12,12,12],
[9,9,9,9,9,9,9,9,9,136,12,12,12,12,12,12,40,41,114,115,53,135,12,12,12,12,12,12,12,12,87,88,9,9,9,9,9,9,9,9,9,9,9,9,134,12,12,12],
[9,9,9,9,9,9,9,9,9,136,12,12,12,12,12,12,87,88,63,39,65,125,12,12,12,12,12,12,12,12,57,58,9,9,9,9,9,9,9,9,9,13,9,9,134,12,12,12],
[9,9,9,9,9,9,9,9,9,136,12,12,12,12,12,12,87,88,38,130,126,127,12,12,12,12,12,12,12,12,12,12,131,131,131,100,101,9,9,9,9,9,9,9,134,12,12,12]]