[[9,9,9,9,9,9,9,9,9,9,9,9,9,9,9,116,9,9,9,9,9,9,9,9,9,9,9,9,117,9,9,9,9,9,9,9,9,9,9,116,9,9,9,9,9,9,9,9],
[9,9,9,9,9,9,9,9,9,9,9,9,9,9,9,9,117,9,9,9,9,9,9,9,9,9,9,9,9,9,9,9,9,9,9,9,9,9,9,9,9,9,9,9,128,74,117,9],
[9,9,9,9,9,9,9,9,9,9,9,9,9,9,9,9,9,9,9,9,9,9,9,117,9,9,9,9,9,116,9,9,9,9,9,117,70,94,9,9,9,9,117,9,85,86,9,9],
[9,9,9,9,9,9,9,117,9,9,9,9,9,9,9,9,9,9,9,9,9,9,9,61,9,9,9,9,9,9,9,9,9,9,9,9,102,103,9,95,96,9,9,9,9,9,9,9],
[9,9,9,9,9,9,9,9,116,9,9,9,9,117,9,9,9,9,9,9,9,9,138,9,9,9,9,9,9,9,9,9,9,9,9,9,9,9,9,104,105,9,9,9,9,9,9,9],
[9,9,9,9,9,9,9,9,9,9,9,9,9,9,9,9,9,9,9,9,9,9,9,9,9,9,9,9,9,139,9,9,9,9,9,9,13,9,9,9,9,9,9,9,9,116,9,9],
[9,9,9,9,9,9,9,19,9,9,35,9,9,9,9,9,9,9,9,9,9,9,9,9,9,9,9,9,137,9,9,9,9,9,9,9,9,129,97,9,9,9,9,35,9,9,9,9],
[9,9,116,9,9,9,9,9,117,9,19,117,9,9,9,116,9,9,9,9,9,9,9,9,9,9,9,9,9,9,96,9,9,9,9,9,9,106,107,9,9,9,9,9,9,9,9,9],
[117,9,9,9,9,9,9,9,11,35,116,13,21,117,35,9,9,9,9,9,9,9,9,9,139,9,9,9,9,9,9,9,9,9,9,9,9,9,9,9,9,9,9,9,9,9,9,9],
[9,9,9,9,9,9,10,117,21,117,117,117,116,117,117,9,9,9,11,138,139,9,9,9,9,138,9,9,9,9,9,9,9,9,9,9,9,9,9,9,9,9,9,9,117,9,9,9],
[9,9,9,9,9,13,138,9,117,116,117,116,117,117,23,9,9,9,139,9,137,13,9,9,9,9,9,9,9,9,9,9,70,96,9,9,9,9,9,9,9,9,9,9,9,84,9,9],
[9,9,9,9,9,9,9,15,35,117,116,117,116,9,116,9,9,9,9,11,9,9,9,9,9,9,9,9,9,9,9,9,102,84,116,95,96,13,9,9,9,9,9,9,9,9,9,9],
[9,9,9,9,137,9,35,9,117,11,15,21,117,13,9,19,137,9,9,9,9,9,9,9,9,9,9,9,9,9,9,9,9,93,94,104,105,70,71,116,9,9,9,9,9,9,9,9],
[9,9,9,9,9,19,9,138,10,9,138,9,9,139,9,9,9,9,9,9,9,9,9,9,9,9,9,9,9,9,9,9,9,102,103,9,9,81,82,72,73,72,94,9,9,9,9,9],
[9,9,9,9,9,9,9,139,9,9,9,9,9,9,9,9,9,9,9,9,9,9,9,9,9,9,9,9,9,9,9,9,9,9,9,9,9,9,9,83,84,81,105,9,9,9,9,9],
[9,9,9,9,9,9,9,9,9,9,9,9,9,9,9,9,9,9,9,9,9,9,9,9,9,9,9,9,9,9,9,9,9,9,9,9,9,9,9,9,9,93,96,9,9,9,9,9],
[9,9,9,9,9,9,9,9,9,9,9,9,9,9,9,9,9,9,9,9,9,9,9,9,9,116,117,9,9,9,9,9,9,9,9,9,9,9,9,9,9,83,82,117,9,9,9,9],
[9,9,9,9,9,9,9,9,9,9,9,9,9,9,9,9,9,9,9,9,9,9,9,9,9,9,9,9,9,9,9,9,9,9,9,9,9,9,9,9,9,9,70,73,9,9,9,9],
[9,9,9,9,9,9,9,9,9,9,9,9,9,9,9,9,9,9,9,117,9,9,9,9,9,9,9,9,9,9,9,9,9,9,9,9,9,9,9,9,9,9,104,103,9,9,9,9],
[9,9,9,9,66,67,9,9,9,9,9,9,9,9,9,9,9,9,9,9,9,9,9,9,9,9,9,9,9,9,9,9,9,9,9,9,9,9,9,9,9,9,9,9,9,9,9,9],
[9,9,9,9,68,69,9,9,9,9,9,9,9,9,9,9,9,119,9,9,9,9,9,9,9,118,34,120,9,9,9,9,9,9,9,9,9,9,9,9,9,9,9,9,9,9,9,9],
[9,9,9,9,9,9,9,9,9,9,9,9,9,9,9,9,118,34,9,9,9,9,9,9,9,46,47,140,9,9,9,117,116,9,9,9,9,9,9,9,9,9,9,9,9,9,9,9],
[9,9,9,9,9,9,9,9,9,9,9,9,9,9,9,119,46,47,9,9,9,9,9,9,9,119,140,9,9,9,9,117,9,9,9,9,9,9,9,9,9,9,9,9,9,9,9,9],
[9,9,9,9,9,9,9,9,9,9,9,9,9,9,9,9,9,9,9,9,9,9,9,9,9,9,9,9,9,9,9,9,9,9,117,9,9,9,9,9,9,9,9,9,9,9,9,9],
[9,9,9,9,9,9,9,9,9,9,9,9,9,9,9,9,9,9,9,9,9,9,9,9,9,9,9,9,9,9,9,9,9,9,9,9,9,9,9,9,9,9,9,9,9,9,9,9],
[9,9,9,9,9,9,9,9,9,9,9,9,9,9,9,9,9,9,9,9,9,9,9,9,9,9,9,9,9,9,9,9,9,9,9,9,9,9,9,9,9,9,9,9,9,9,9,9],
[9,9,9,9,9,9,9,9,9,9,9,9,9,9,9,9,9,121,120,9,9,9,9,9,9,9,9,9,9,9,9,9,9,9,9,9,9,9,139,9,9,9,9,9,9,9,9,9],
[9,9,9,9,9,9,9,9,9,9,9,9,9,9,9,9,9,119,119,9,9,9,9,9,9,119,120,9,9,9,9,9,9,9,9,9,9,9,9,9,9,9,9,9,9,9,9,9],
[9,9,9,9,9,9,9,9,9,9,9,9,9,9,9,9,9,9,9,9,9,9,9,9,9,9,9,9,9,9,9,9,9,9,9,9,121,119,9,9,9,9,9,72,73,9,9,9],
[9,9,9,9,9,9,9,9,9,9,9,9,9,9,9,9,9,9,9,9,9,9,9,9,9,9,9,9,9,9,9,9,9,9,9,9,9,9,120,9,9,9,9,83,84,9,9,9],
[9,9,9,9,120,9,9,9,9,9,9,9,9,9,9,119,120,9,9,9,119,9,9,9,9,9,9,9,9,9,9,9,9,9,9,9,9,9,9,9,9,9,9,9,9,9,9,9],
[9,9,9,9,9,119,9,9,9,9,9,9,9,9,9,120,120,9,9,9,9,9,9,9,9,9,9,9,9,9,9,119,9,9,9,9,9,9,9,9,9,9,9,9,9,9,9,9],
[9,9,9,9,9,120,119,9,9,9,9,9,9,9,9,9,9,119,9,9,9,9,9,9,9,9,9,9,9,9,9,9,120,9,9,9,9,9,9,9,9,9,9,9,9,9,9,9],
[9,9,9,9,9,9,9,120,9,9,9,9,9,9,9,9,9,9,9,9,9,9,9,9,9,9,9,9,9,9,140,121,140,119,9,9,9,9,9,9,9,9,9,9,9,9,9,9],
[9,9,9,9,9,9,9,9,9,9,9,9,9,9,9,9,9,9,9,9,9,9,9,9,9,9,9,9,9,9,119,140,140,9,9,9,9,9,9,9,9,9,9,9,9,9,9,9],
[9,9,9,9,9,9,9,119,9,9,9,9,9,9,9,9,9,9,9,9,9,9,9,9,9,9,9,9,9,9,9,120,9,9,9,9,9,9,9,9,9,9,9,9,9,9,9,9],
[9,9,9,9,9,9,9,119,9,9,9,9,9,9,9,9,9,9,9,9,9,9,9,9,9,9,9,9,9,9,9,9,9,9,9,9,9,9,9,9,9,9,9,9,9,9,9,9],
[9,9,9,119,120,119,9,9,120,9,9,9,9,9,9,9,9,9,9,9,9,9,9,9,9,9,9,9,9,9,9,9,9,9,9,9,9,9,9,9,70,71,9,9,9,9,9,9],
[9,9,120,120,118,34,140,15,9,119,9,9,9,9,9,9,9,9,48,9,9,9,9,9,9,9,9,9,9,9,48,9,9,9,9,9,9,9,9,9,81,82,9,9,9,9,9,9],
[9,9,15,119,140,140,118,34,140,120,9,9,9,9,9,9,9,9,9,9,9,9,9,9,9,9,9,9,9,9,9,9,9,9,9,9,9,9,9,9,9,9,9,9,9,9,9,9],
[9,9,120,9,120,118,46,47,34,140,9,9,9,9,9,9,9,9,9,9,9,9,9,9,9,9,9,9,9,9,9,9,9,9,9,9,9,9,9,9,9,9,9,9,9,9,9,9],
[9,9,9,35,15,46,118,34,118,34,119,120,9,9,9,9,9,9,9,9,9,9,9,9,9,9,9,9,9,9,9,9,9,9,9,9,9,9,9,9,120,9,9,9,9,9,119,19],
[9,9,9,9,120,140,46,47,46,47,140,15,9,119,9,9,9,9,9,9,9,9,9,9,9,9,9,9,9,9,9,9,9,9,9,9,9,9,9,9,13,140,120,9,9,120,15,120],
[9,9,9,9,119,140,140,140,140,9,9,35,119,119,120,9,9,9,9,9,9,9,9,9,9,9,9,9,9,9,9,9,9,9,9,9,9,120,9,9,9,118,34,119,15,120,34,140],
[9,9,9,9,9,119,140,119,9,15,118,34,140,118,119,9,9,9,9,9,9,9,9,9,9,9,9,9,9,9,9,9,9,9,9,9,9,9,119,119,120,46,47,140,120,140,119,140],
[9,9,9,9,9,120,15,119,9,119,46,47,121,140,120,9,119,9,9,9,9,9,9,9,9,9,9,9,9,9,9,9,9,9,9,9,9,9,120,120,9,140,35,140,120,34,140,120],
[9,9,9,9,9,9,9,9,9,35,140,140,119,120,9,120,9,9,9,9,9,9,9,9,9,9,9,9,9,9,9,9,9,9,9,9,9,23,9,95,96,119,140,34,140,120,34,119],
[9,9,9,9,9,9,9,9,120,9,9,9,9,9,9,9,9,9,9,9,9,9,9,9,9,9,9,9,9,9,9,9,9,9,9,9,119,9,9,104,105,9,120,140,120,140,119,140]]