[[12,12,12,12,12,75,76,9,9,121,119,9,9,118,34,140,140,120,9,9,9,9,9,9,9,9,36,9,9,9,128,74,135,12,12,12,12,12,12,12,12,12,12,12,12,12,12,12],
[12,28,29,77,78,108,109,9,9,140,120,9,9,46,47,140,120,119,9,118,34,140,119,9,9,9,49,9,9,9,85,86,80,77,78,33,12,12,31,32,77,79,77,78,79,78,33,12],
[12,40,41,89,90,114,115,9,9,9,9,9,9,9,9,9,9,9,9,46,47,140,120,9,9,9,62,64,9,9,9,9,92,89,90,45,12,12,43,44,89,91,89,90,91,90,45,12],
[12,98,99,9,9,9,9,9,119,120,119,118,34,120,9,118,34,119,119,140,118,34,119,9,9,9,9,20,9,9,9,9,9,9,129,97,136,12,87,88,9,9,9,9,9,9,9,134],
[12,87,88,9,9,9,9,120,140,140,140,46,47,140,9,46,47,120,9,9,46,47,140,9,9,9,21,22,23,9,9,9,9,9,106,107,80,78,108,109,9,9,9,9,9,9,9,135],
[12,75,76,9,9,9,9,119,120,119,140,140,118,34,9,120,119,119,9,9,120,140,120,119,9,9,9,24,9,9,9,9,9,9,9,9,92,90,114,115,9,9,9,9,9,9,9,134],
[12,59,60,9,9,9,9,9,9,140,119,120,46,47,9,9,9,120,9,9,9,9,119,120,9,9,9,62,50,54,37,64,9,9,9,9,9,9,9,9,9,9,9,9,9,9,9,136],
[12,12,132,100,101,9,9,9,9,119,120,119,140,119,120,140,9,9,9,118,34,9,9,9,9,9,9,9,9,9,9,62,64,9,9,9,9,9,9,9,9,9,9,9,9,9,9,135],
[12,12,12,87,88,9,9,130,133,132,131,133,100,101,140,140,120,9,9,46,47,9,118,34,9,9,9,9,9,9,9,9,38,9,9,9,9,9,9,9,9,9,9,9,9,9,9,134],
[12,12,12,57,58,9,9,136,12,12,12,12,75,76,118,34,140,9,9,140,119,9,46,47,9,9,9,9,9,9,9,9,51,9,9,9,9,9,9,9,9,9,9,9,9,9,9,135],
[12,12,12,12,12,132,133,12,12,12,12,12,57,58,46,47,119,140,119,140,120,9,140,140,119,120,9,9,9,9,9,9,55,9,9,9,9,9,9,9,9,9,9,9,9,9,9,136],
[12,12,12,12,12,12,12,12,12,12,12,12,12,12,133,132,131,100,101,120,9,9,9,119,140,119,9,9,9,9,9,9,49,9,9,9,15,9,9,9,15,9,9,130,132,133,131,12],
[12,12,12,12,12,12,12,12,12,12,12,12,12,12,12,12,12,75,76,119,9,9,9,9,119,9,9,9,9,9,9,9,62,39,50,16,17,18,56,16,17,18,50,135,12,12,12,12],
[12,12,12,12,12,12,12,12,12,12,12,12,12,12,31,32,79,108,109,9,120,9,9,9,9,9,9,9,9,9,9,9,9,9,9,9,19,9,9,9,19,9,9,136,12,12,12,12],
[12,12,12,12,12,12,12,12,12,12,12,12,12,12,43,44,91,114,115,9,9,9,9,9,9,9,9,9,9,9,9,9,9,9,9,9,9,9,9,9,9,9,9,135,12,12,12,12],
[12,12,28,29,77,78,33,12,12,12,12,12,12,12,98,99,9,9,9,9,9,9,9,9,9,9,9,9,9,9,9,9,9,9,9,9,9,9,9,9,9,9,9,134,12,12,12,12],
[12,12,40,41,89,90,45,12,12,12,12,12,12,12,87,88,9,9,9,9,9,9,9,9,9,9,9,9,9,9,9,9,9,9,9,9,9,9,9,9,9,9,9,135,12,12,12,12],
[12,12,87,88,9,9,9,135,12,12,12,12,12,12,75,76,9,9,9,9,9,9,9,9,9,9,9,9,9,9,9,9,9,9,9,9,9,9,9,9,9,9,9,136,12,12,12,12],
[12,12,75,76,9,9,9,80,79,78,77,79,78,77,108,109,9,9,9,9,9,9,9,9,9,9,63,50,37,56,25,9,63,50,64,9,9,9,9,9,130,133,131,12,12,12,12,12],
[77,78,108,109,9,9,9,92,91,90,89,91,90,89,114,115,9,9,9,9,9,9,9,9,63,54,65,9,9,9,9,9,62,64,62,50,39,50,56,37,134,12,12,12,12,12,12,12],
[89,90,114,115,9,9,9,9,9,9,9,9,9,9,9,9,9,9,9,9,9,9,9,63,65,9,9,9,9,9,9,9,9,62,64,117,116,10,9,137,136,12,12,12,12,12,12,12],
[9,9,9,9,9,9,9,9,9,9,9,9,9,9,9,9,9,9,9,9,9,9,9,55,9,9,9,9,9,9,9,9,9,9,38,139,9,11,117,117,135,12,12,28,29,79,78,77],
[9,9,9,9,9,9,9,9,9,9,9,9,9,9,9,9,9,9,9,9,9,9,9,49,9,9,9,9,9,9,9,9,9,63,65,117,13,117,116,13,136,12,12,40,41,91,90,89],
[9,9,9,9,9,9,9,9,9,9,9,9,9,9,9,9,9,9,9,63,56,37,50,65,9,9,9,9,9,9,9,9,9,53,117,66,67,138,11,138,134,12,12,75,76,130,133,132],
[131,132,100,101,9,9,9,9,9,9,9,9,9,9,9,9,9,9,9,38,9,9,9,9,9,9,9,9,9,9,9,9,9,51,116,68,69,116,9,116,134,12,12,87,88,134,133,132],
[12,12,87,88,9,9,9,9,9,9,9,9,9,9,9,9,9,9,9,53,9,9,9,9,9,9,9,9,9,9,9,9,9,55,9,116,117,117,130,131,12,12,12,98,99,135,31,32],
[12,12,57,58,9,9,9,9,9,9,9,9,9,9,63,52,37,50,54,65,9,9,9,9,9,9,9,9,9,9,9,9,9,36,117,139,117,116,135,12,12,12,28,108,109,136,87,44],
[12,12,12,12,131,100,101,9,9,9,9,9,9,9,38,9,9,9,9,9,9,9,9,9,9,9,9,9,9,9,9,9,9,53,138,117,116,13,136,12,12,12,40,41,115,80,108,109],
[12,12,12,12,12,87,88,9,9,9,9,9,9,63,65,9,9,9,9,9,9,9,9,9,9,9,9,9,9,9,63,37,50,65,13,116,10,117,134,12,12,12,57,58,35,92,114,115],
[12,12,12,12,12,98,99,9,9,9,9,9,9,51,9,9,9,9,9,9,9,9,9,9,9,9,9,9,9,9,49,137,11,9,117,11,9,9,135,12,12,12,12,12,131,132,133,131],
[12,12,12,12,12,75,76,9,9,9,9,9,9,53,9,9,9,9,9,9,9,9,9,9,9,9,9,9,9,9,62,64,9,35,9,9,117,9,136,12,12,12,12,12,12,12,12,12],
[12,12,12,12,12,87,88,9,9,9,9,9,9,36,9,9,9,9,9,9,9,9,9,9,9,9,9,9,9,9,9,62,37,56,64,138,13,9,134,12,12,12,12,12,12,12,12,12],
[12,12,12,12,12,98,99,9,9,63,52,54,50,65,9,9,9,9,9,9,9,9,9,9,9,9,9,9,9,9,9,9,9,9,62,52,64,117,135,12,12,12,12,12,12,12,12,12],
[12,12,12,12,12,57,58,9,9,38,139,11,14,9,9,63,54,64,9,9,9,9,9,9,9,9,9,9,9,9,9,9,9,9,9,9,53,10,136,12,12,12,12,12,12,12,12,12],
[12,12,12,12,12,12,12,133,131,132,100,101,62,54,64,51,138,55,9,9,9,9,9,9,9,9,9,9,9,9,9,9,9,63,39,54,65,139,134,12,12,12,12,12,12,12,12,12],
[12,12,12,12,12,12,12,12,12,12,87,88,9,117,49,51,9,49,9,9,9,9,9,9,9,9,9,9,9,9,9,9,9,38,9,11,9,137,135,12,12,12,12,12,12,12,12,12],
[12,12,12,12,12,12,12,12,12,12,75,76,61,9,62,65,35,62,64,9,9,9,9,9,9,9,9,9,9,9,9,9,9,130,131,133,132,133,12,12,12,12,12,12,12,12,12,12],
[12,12,12,12,12,12,12,12,12,12,59,60,35,137,9,11,9,10,38,9,9,9,9,9,9,9,9,9,9,9,9,9,9,135,12,12,12,12,12,12,12,12,12,12,12,12,12,12],
[12,12,12,12,12,12,12,12,12,12,12,12,133,132,131,100,101,116,55,9,9,9,9,9,9,9,9,9,9,9,9,9,9,134,12,12,12,12,12,12,12,12,28,29,77,78,79,77],
[12,12,28,29,78,30,12,12,12,12,12,12,12,12,12,75,76,9,62,39,54,64,9,9,9,9,9,9,9,9,9,9,9,135,12,12,12,12,12,12,12,12,40,41,89,90,91,89],
[12,12,40,41,90,42,12,12,12,12,12,12,12,12,12,59,60,35,11,117,35,38,9,9,9,9,9,9,9,9,9,9,9,136,12,12,12,12,12,12,31,32,108,109,9,9,9,9],
[79,78,108,109,129,97,136,12,12,12,12,12,12,12,12,12,12,132,100,101,10,55,9,9,9,9,9,9,9,9,130,132,133,12,12,12,12,12,12,12,43,44,114,115,117,63,50,50],
[91,90,114,115,106,107,134,12,12,12,12,12,12,12,12,12,12,12,57,58,116,49,9,9,9,9,9,9,9,9,135,12,12,12,12,12,12,12,12,12,87,88,35,9,9,51,9,10],
[133,131,133,100,101,9,80,79,77,78,33,12,12,12,12,12,12,12,12,12,131,133,132,131,133,132,133,131,132,133,12,12,12,12,12,12,12,12,12,12,75,76,137,63,50,65,11,9],
[12,12,12,57,58,9,92,91,89,90,45,12,12,12,12,12,12,12,12,12,12,12,12,12,12,12,12,12,12,12,12,12,28,29,78,77,79,77,78,79,108,109,9,51,9,116,9,9],
[12,12,12,12,12,133,132,131,133,100,101,135,12,12,12,12,12,12,12,12,12,12,12,12,12,12,12,12,12,12,12,12,40,41,90,89,91,89,90,91,114,115,116,51,9,128,74,139],
[12,12,12,12,12,12,12,12,12,87,88,136,12,12,12,12,12,12,12,12,12,12,12,12,12,31,32,78,77,77,77,79,108,109,9,61,138,9,63,50,50,50,50,65,9,85,86,9],
[12,12,12,12,12,12,12,12,12,59,60,134,12,12,12,12,12,12,12,12,12,12,12,12,12,43,44,90,89,89,89,91,114,115,117,9,9,9,55,13,137,9,9,9,117,9,9,13]]