[[117,114,131,9,9,112,113,115,116,9,9,9,113,9,9,9,9,112,9,9,9,113,112,115,9,9,9,9,9,9,9,9,9,9,9,9,9,120,115,114,113,117,112,115,116,117,118,115],
[120,110,132,9,9,9,9,9,9,9,9,9,116,9,9,9,9,115,9,9,9,116,113,116,9,9,9,9,9,9,9,9,9,9,9,9,9,9,117,115,112,126,115,112,113,116,113,112],
[9,9,9,9,9,9,9,9,9,9,9,9,9,9,9,9,9,9,9,9,9,113,116,124,9,9,9,9,9,9,9,9,9,9,9,9,9,9,116,112,116,113,116,115,112,125,116,118],
[9,9,9,9,9,9,9,9,9,9,9,9,9,9,9,9,87,9,9,9,9,9,9,9,9,116,131,9,9,9,9,9,9,9,9,9,9,17,133,110,115,117,112,116,113,104,132,113],
[9,9,9,9,9,9,9,9,9,9,9,9,9,9,9,9,116,9,9,9,9,9,9,9,9,133,132,9,9,9,9,9,9,9,9,9,9,9,9,9,9,120,113,115,116,115,112,114],
[9,9,9,9,9,9,9,9,9,9,9,9,9,124,122,9,115,9,9,9,9,9,9,9,9,9,9,9,9,9,9,9,9,9,9,9,9,9,128,85,86,124,122,112,115,113,116,115],
[9,9,9,9,132,9,9,9,9,9,9,9,9,41,42,9,132,112,131,9,9,9,114,116,113,9,9,9,9,9,9,9,9,9,9,9,9,9,93,94,95,41,42,116,117,116,113,131],
[9,9,9,9,131,9,9,9,9,9,9,9,9,9,9,9,9,9,9,9,9,9,131,9,9,9,9,9,9,9,9,9,9,9,9,9,9,9,99,100,101,9,119,112,115,112,116,116],
[9,9,9,9,9,9,9,9,9,9,9,9,9,9,9,9,9,9,9,131,113,116,132,9,9,9,9,9,9,9,9,9,9,9,131,70,70,132,9,9,9,9,115,113,117,116,113,59],
[9,9,9,9,9,9,9,9,123,9,9,9,9,9,9,9,9,9,9,116,133,9,9,9,9,9,9,9,9,9,9,9,9,9,109,115,114,110,9,119,116,9,9,9,116,112,59,34],
[9,9,9,9,9,9,9,9,131,9,9,9,9,9,9,9,131,9,9,9,9,9,9,9,9,9,9,9,9,9,9,9,9,9,133,117,118,9,9,117,115,117,112,9,116,123,58,10],
[9,9,9,9,9,9,133,9,9,9,9,9,9,9,9,9,9,9,9,9,9,9,9,9,9,9,9,9,9,9,9,9,9,9,9,109,113,118,11,87,112,113,113,59,18,18,34,10],
[119,70,11,9,119,113,116,9,9,9,9,9,9,9,9,87,116,9,9,9,9,9,9,9,9,9,9,9,9,9,9,9,132,9,9,109,116,115,113,112,112,116,59,34,10,10,10,10],
[113,115,118,119,116,118,110,9,9,9,9,131,132,9,131,116,133,9,9,9,9,9,9,9,9,9,9,9,9,9,9,9,109,118,119,115,112,116,116,115,115,59,34,10,10,10,10,10],
[116,125,112,87,113,131,115,132,9,9,9,9,9,9,9,9,9,9,9,9,9,9,9,9,9,9,9,9,9,9,9,9,109,110,116,113,117,115,112,117,112,58,10,10,10,10,10,10],
[117,118,115,110,120,113,112,133,9,9,9,9,9,9,9,9,9,9,9,9,9,9,9,9,9,9,9,9,9,9,9,115,87,115,113,116,113,116,115,113,112,58,10,10,10,10,10,10],
[112,115,114,9,9,120,116,131,9,9,9,9,9,9,9,9,9,9,9,9,9,9,9,9,9,9,9,132,11,116,11,113,115,112,122,116,115,130,39,40,116,62,33,10,10,10,10,10],
[116,9,9,9,9,9,9,9,9,9,9,9,9,9,9,9,9,9,9,9,9,9,9,9,9,9,9,87,113,116,113,116,117,113,129,37,38,52,53,54,113,116,62,33,10,36,63,33],
[110,9,9,9,9,9,9,9,9,9,9,9,9,9,9,9,17,9,9,9,9,9,9,9,9,9,119,116,115,112,115,112,113,113,49,50,51,67,68,69,115,117,112,58,10,48,124,62],
[9,9,9,9,9,9,9,9,9,9,9,9,133,11,9,9,9,9,9,9,9,9,9,9,9,131,112,114,113,113,116,113,115,112,64,65,66,116,113,116,113,115,113,62,63,61,123,116],
[9,9,9,9,9,9,9,9,14,11,119,70,87,121,122,9,9,9,9,9,9,9,9,9,9,9,117,112,116,115,131,115,113,116,115,105,116,112,112,115,124,122,116,115,9,113,115,114],
[9,9,9,9,9,9,9,119,87,118,87,114,117,41,42,9,9,14,119,133,9,9,9,9,9,9,120,115,116,113,121,103,115,113,116,113,115,116,113,116,41,42,115,117,9,9,116,113],
[9,9,9,9,9,9,123,120,117,114,108,110,120,113,133,9,9,119,87,118,13,9,9,9,9,9,9,116,113,115,106,107,116,115,117,115,112,113,115,113,115,116,113,114,115,9,112,115],
[119,11,9,9,9,9,9,124,120,133,9,9,9,9,9,9,9,112,117,114,110,9,9,9,9,9,9,9,117,113,116,115,116,113,115,110,116,117,114,120,112,120,114,108,117,9,116,122],
[87,112,113,9,9,9,9,9,9,9,9,9,9,9,9,9,9,9,131,116,9,9,9,9,9,9,9,9,9,9,120,116,110,120,113,11,9,109,111,9,9,9,132,9,9,9,116,113],
[115,116,87,11,9,9,9,9,9,9,9,9,9,9,9,9,9,9,9,9,9,9,9,9,9,9,9,9,9,9,9,9,9,9,131,9,9,109,111,9,9,9,9,9,117,113,115,112],
[112,113,112,113,9,9,9,9,9,9,9,9,9,9,9,9,9,9,9,9,9,9,9,9,9,9,9,9,9,9,9,9,9,9,9,9,9,131,110,133,9,9,9,9,9,120,113,114],
[117,116,112,115,118,115,9,9,119,131,9,9,9,9,9,9,9,9,9,9,9,9,9,9,9,9,9,9,9,9,9,9,9,9,9,9,9,9,9,9,9,9,9,9,119,9,9,115],
[115,116,133,113,112,115,113,9,112,113,9,9,9,9,9,9,9,9,9,9,9,9,9,9,9,9,9,9,9,9,9,9,9,9,9,9,9,9,9,9,9,9,9,9,87,113,9,59],
[131,115,117,115,116,116,87,112,116,9,9,9,9,9,9,9,9,9,9,9,9,9,9,9,9,9,9,9,9,9,9,9,9,9,9,9,9,9,9,9,9,9,131,119,116,59,18,34],
[113,116,116,112,116,113,112,117,115,116,11,9,9,9,9,9,9,9,9,9,9,9,9,9,9,9,9,9,9,9,9,9,9,9,9,9,9,9,9,9,9,9,9,117,112,58,10,10],
[116,115,113,116,115,116,118,115,116,113,115,114,9,9,9,9,9,9,9,9,9,9,9,9,9,9,9,9,9,9,9,9,9,9,9,9,9,9,9,9,9,9,9,9,116,62,33,10],
[118,116,115,124,116,113,116,116,112,116,110,9,9,9,9,9,9,9,9,9,9,9,9,9,9,9,9,9,9,9,9,9,9,9,9,9,9,9,9,9,9,9,9,119,87,115,62,63],
[116,116,116,112,87,116,115,87,116,115,113,11,119,113,9,9,9,9,9,9,9,9,9,9,9,9,9,9,131,11,15,9,9,9,9,9,9,9,9,9,9,9,9,131,113,117,113,9],
[112,122,116,116,113,114,112,116,113,112,116,114,113,116,11,9,132,9,9,9,9,9,9,9,9,9,13,9,120,132,9,9,9,9,9,9,9,9,9,9,9,9,9,9,9,9,9,9],
[114,116,112,115,114,115,116,115,116,117,121,116,117,115,113,116,117,113,9,9,9,9,9,9,9,9,9,9,133,9,9,9,9,9,9,9,9,9,9,9,9,9,9,9,9,115,117,113],
[112,115,113,112,113,112,115,118,116,115,116,122,112,116,115,117,115,114,118,113,9,9,119,112,87,9,9,9,9,9,9,9,9,9,119,115,11,9,9,9,9,9,9,11,119,113,116,131],
[87,112,116,116,115,116,117,112,116,114,112,87,113,115,113,116,113,115,112,116,112,87,115,118,113,11,9,9,9,9,131,9,9,115,115,114,116,118,9,9,9,9,87,116,112,115,131,114],
[116,113,115,112,115,112,113,114,112,115,113,112,115,118,116,114,116,116,123,113,115,116,113,113,112,115,131,9,9,132,116,119,113,115,116,113,122,115,11,9,9,113,112,41,117,112,113,112],
[115,117,116,115,114,116,118,113,87,116,112,115,112,113,132,116,115,113,116,115,114,112,115,116,113,110,9,9,9,9,117,115,87,113,118,112,115,114,116,113,11,116,115,131,113,116,123,115],
[112,116,118,112,115,87,113,115,116,113,124,113,115,112,115,112,113,116,87,113,112,87,114,112,9,9,9,9,9,9,112,121,115,116,112,115,116,113,117,112,115,87,113,116,115,132,112,116],
[113,106,115,87,116,112,132,116,114,116,114,116,112,114,115,116,117,116,131,115,117,112,132,9,9,9,9,9,9,119,87,113,42,113,116,117,113,116,115,113,116,131,116,113,112,116,116,87],
[117,116,116,115,113,113,117,115,113,112,113,115,114,112,112,115,113,115,115,113,120,110,9,9,9,9,9,9,9,116,115,115,116,115,115,112,118,124,113,87,112,112,125,122,115,113,115,132],
[116,115,114,113,117,115,114,116,115,118,116,87,112,116,117,112,116,117,113,110,9,9,9,9,9,9,9,9,9,120,117,113,115,116,87,113,116,115,112,116,113,116,121,105,116,132,112,116],
[113,112,115,114,113,112,125,122,112,112,112,113,117,115,114,113,120,115,9,9,9,9,9,9,9,9,9,9,9,119,115,118,113,114,115,117,115,112,113,115,112,113,115,116,112,115,115,117],
[112,116,112,115,117,116,41,116,115,117,116,115,113,11,9,9,9,9,9,9,9,9,9,9,9,9,9,9,9,9,117,115,116,115,112,113,115,103,112,115,113,112,113,115,132,116,115,132],
[118,115,116,114,113,118,113,87,116,112,113,112,87,112,9,9,9,9,9,9,9,9,9,9,9,9,9,9,9,9,120,9,120,112,117,115,106,113,115,113,112,117,117,112,116,115,122,113],
[104,87,115,113,131,115,132,118,113,41,116,117,113,112,11,9,9,9,9,9,9,9,9,9,9,9,9,9,9,9,9,9,9,110,9,113,115,112,118,116,113,87,116,87,115,114,132,117]]