[[10,10,10,10,10,10,10,10,10,48,109,113,115,116,112,114,110,9,9,9,9,9,9,9,9,9,9,9,9,9,9,120,108,132,112,112,113,112,112,115,112,113,112,112,111,58,10,10],
[10,10,10,10,10,10,10,10,10,48,109,114,117,114,108,110,9,9,9,9,9,9,9,9,9,9,9,9,9,9,9,9,9,9,117,112,115,112,112,112,112,116,113,112,111,58,10,10],
[10,10,10,10,10,10,10,10,10,48,87,111,9,9,9,9,9,9,9,9,9,9,9,9,9,9,9,9,9,9,9,9,9,9,120,132,112,116,115,112,113,112,112,115,132,58,10,10],
[10,10,10,10,10,10,10,10,10,48,131,114,9,9,9,9,9,9,9,9,9,9,9,9,9,9,9,9,9,9,9,9,9,9,9,120,117,112,112,112,115,112,112,115,111,58,10,10],
[10,10,10,10,10,10,10,10,10,48,9,9,9,9,9,9,9,9,9,9,9,9,9,9,9,9,9,9,9,9,9,9,9,9,9,9,116,108,108,117,114,108,108,117,118,58,10,10],
[10,10,10,10,10,10,10,10,10,48,9,132,116,9,9,9,9,9,9,9,9,9,9,9,9,9,9,9,9,9,9,9,9,9,9,9,9,9,9,9,9,9,9,120,117,58,10,10],
[10,10,10,10,10,10,10,10,10,35,60,109,111,9,9,9,9,9,9,9,9,9,9,9,9,9,9,9,9,9,9,9,9,9,9,9,9,9,9,9,9,9,9,9,133,58,10,10],
[10,10,10,10,10,10,10,10,10,10,48,87,111,9,9,9,9,9,9,9,9,9,9,9,9,9,9,9,9,9,9,9,9,9,9,9,9,9,9,9,9,9,131,9,9,58,10,10],
[10,10,10,10,10,10,10,10,10,10,48,117,118,9,9,9,9,9,9,9,9,9,9,9,9,9,9,9,9,9,9,9,9,9,9,9,9,9,9,9,9,9,113,118,59,34,10,10],
[10,10,10,10,10,10,10,10,10,10,48,133,114,9,9,9,9,9,9,9,9,9,9,9,9,9,9,9,9,9,9,9,9,9,9,9,9,9,9,9,9,112,114,131,58,10,10,10],
[10,10,10,10,10,10,36,63,33,10,48,120,117,118,9,9,9,9,9,9,9,9,9,9,9,9,9,9,9,9,9,9,9,9,9,9,9,9,9,9,115,116,110,59,34,10,10,10],
[10,10,10,10,10,36,61,131,62,33,35,60,132,117,11,9,9,9,9,9,9,9,9,9,9,9,9,9,9,9,9,9,9,9,9,9,9,9,9,87,114,132,59,34,10,10,10,10],
[10,10,10,36,63,61,9,109,132,62,33,35,60,120,115,131,9,9,9,9,9,9,9,9,9,9,9,9,9,9,9,9,9,9,9,9,9,9,112,113,110,59,34,36,63,33,10,10],
[10,10,10,48,119,118,9,87,118,11,58,10,35,60,114,110,9,9,9,9,9,9,9,9,9,9,9,9,9,9,9,9,9,9,9,9,9,132,114,133,59,34,36,61,131,58,10,10],
[10,10,10,48,112,111,9,116,112,118,58,10,10,48,132,9,9,119,131,11,9,9,9,9,9,9,9,9,9,9,9,9,119,87,118,116,9,115,110,59,34,36,61,132,87,62,33,10],
[10,10,10,48,113,114,9,9,113,114,58,10,10,35,60,9,114,108,117,118,132,9,9,9,9,9,9,9,9,9,119,114,117,114,108,133,9,59,18,34,36,61,109,129,37,38,58,10],
[10,10,10,48,132,9,9,114,133,59,34,10,10,10,35,18,18,18,18,60,117,133,87,118,116,9,9,9,114,108,117,132,59,18,18,18,18,34,10,10,48,119,87,49,50,51,58,10],
[10,10,10,48,117,118,9,131,59,34,10,10,10,10,10,10,10,10,10,35,18,18,60,117,111,9,9,114,132,59,18,18,34,10,10,10,10,10,10,10,48,133,117,64,65,66,58,10],
[10,10,10,35,60,131,9,9,58,10,10,10,10,10,10,10,10,10,10,10,10,10,35,60,132,9,9,131,59,34,10,10,10,10,10,10,10,10,10,10,35,60,132,108,132,59,34,10],
[10,10,10,10,35,18,18,18,34,10,10,10,10,10,10,10,10,10,10,10,10,10,10,35,60,9,9,59,34,10,10,10,10,10,10,10,10,10,10,10,10,35,18,18,18,34,10,10],
[10,10,10,10,10,10,10,10,10,10,10,10,10,10,10,10,10,10,10,10,10,10,10,10,48,9,9,58,10,10,10,10,10,10,10,10,10,10,10,10,10,10,10,36,63,33,10,10],
[10,10,10,10,36,63,63,33,10,10,10,10,10,10,10,10,10,10,10,10,36,63,63,63,61,9,9,62,63,33,10,10,10,10,10,10,10,10,10,10,10,10,36,61,131,62,33,10],
[10,10,10,10,48,119,116,62,33,10,10,10,10,10,10,10,10,10,10,36,61,119,70,116,9,9,9,9,115,62,33,10,10,10,10,10,10,10,10,10,10,10,48,9,113,118,58,10],
[10,10,10,10,48,87,113,118,62,33,10,10,10,10,10,10,10,10,36,61,119,87,112,111,9,9,9,9,113,11,58,10,10,10,10,10,10,10,10,10,10,10,48,9,9,114,58,10],
[10,10,10,10,48,117,112,121,122,58,10,10,10,10,10,36,63,63,61,119,112,113,112,113,9,9,9,9,115,116,58,10,10,10,10,10,10,10,10,10,10,10,48,133,114,59,34,10],
[10,10,10,10,48,120,115,41,42,58,10,10,10,10,10,48,112,70,131,87,112,114,108,110,9,9,9,9,112,110,58,10,10,10,10,10,10,10,10,10,10,10,35,18,18,34,10,10],
[10,10,10,10,35,60,117,112,133,58,10,10,10,10,10,48,109,113,112,116,112,132,59,18,60,9,9,9,132,59,34,10,10,10,10,10,10,10,10,10,10,36,63,63,63,33,10,10],
[10,10,10,10,10,35,18,18,18,34,10,10,10,10,10,48,115,112,112,113,112,118,58,10,48,9,9,9,113,58,10,10,10,10,10,10,10,10,10,10,10,48,126,103,118,58,10,10],
[10,10,10,10,10,10,10,10,10,10,10,10,10,10,10,48,120,133,115,112,115,114,58,10,48,9,9,9,115,58,10,10,10,10,10,10,10,10,10,10,10,48,106,107,132,58,10,10],
[10,10,10,10,10,10,10,10,10,10,10,10,10,10,10,35,60,120,108,117,112,111,58,10,48,9,9,113,114,58,10,10,10,10,10,10,10,10,10,10,10,48,117,133,59,34,10,10],
[10,10,10,10,10,10,36,63,63,63,33,10,10,10,10,10,35,18,60,120,116,131,58,10,48,9,9,116,59,34,10,10,10,10,10,10,10,36,63,63,33,35,18,18,34,10,10,10],
[10,10,10,10,10,10,48,113,114,9,58,10,10,10,10,10,10,10,35,18,18,18,34,10,48,9,9,59,34,10,10,10,10,10,10,10,10,48,87,118,62,33,10,10,10,10,10,10],
[10,10,10,10,10,36,61,112,111,9,62,63,33,10,10,10,10,10,10,10,10,10,10,36,61,9,9,58,10,10,10,10,10,10,10,10,10,48,132,9,118,62,63,33,10,10,10,10],
[10,10,10,10,10,48,116,9,118,9,9,131,58,10,10,10,10,10,10,10,10,10,36,61,131,9,9,62,33,10,10,10,10,10,10,10,10,48,116,9,133,70,11,58,10,10,10,10],
[10,10,10,10,10,48,112,115,114,117,114,133,58,10,10,10,10,10,36,63,63,63,61,113,111,9,9,133,62,33,10,10,10,10,10,10,10,48,9,9,9,112,111,58,10,10,10,10],
[10,10,10,10,10,48,120,117,111,9,110,59,34,10,10,10,10,36,61,87,112,113,112,114,110,9,9,113,118,62,63,63,63,63,63,33,10,48,120,113,9,114,132,58,10,10,10,10],
[10,10,10,10,10,35,18,60,117,132,59,34,10,10,36,63,63,61,87,114,108,108,117,132,9,9,9,131,117,87,87,118,70,87,132,62,33,35,60,117,114,110,59,34,10,10,10,10],
[10,10,10,10,10,10,10,35,18,18,34,36,63,63,61,87,112,113,114,133,9,9,9,9,9,9,9,9,120,108,108,133,108,108,117,11,62,33,35,60,131,9,58,10,10,10,10,10],
[10,10,10,10,10,10,10,10,10,36,63,61,119,87,113,108,108,110,9,9,9,9,9,9,9,9,9,9,9,9,9,9,9,9,133,118,132,62,33,35,18,18,34,10,10,10,10,10],
[10,10,10,10,10,10,10,10,36,61,87,114,113,110,133,9,9,9,9,9,9,9,9,9,9,9,9,9,9,9,9,9,9,9,9,115,118,11,62,33,10,10,10,10,10,10,10,10],
[10,10,10,10,10,10,10,10,48,119,113,110,9,9,9,9,9,9,9,9,9,9,9,9,9,9,9,9,9,9,9,9,9,9,9,9,117,118,133,58,10,10,10,10,10,10,10,10],
[10,10,10,10,10,10,10,10,48,87,111,9,9,9,9,9,9,9,9,9,9,9,9,9,9,9,9,9,9,9,9,9,9,9,9,9,9,113,111,62,33,10,10,10,10,10,10,10],
[10,10,10,10,10,10,10,10,48,117,111,9,9,9,9,9,9,9,9,9,9,9,9,9,9,9,9,9,9,9,9,9,9,9,9,9,9,117,118,131,58,10,10,10,10,10,10,10],
[10,10,10,10,10,10,10,36,61,112,111,9,9,9,9,9,9,9,9,9,9,9,9,9,9,9,9,9,9,9,9,9,9,9,9,9,9,9,117,111,58,10,10,10,10,10,10,10],
[10,10,10,10,10,10,10,48,87,112,111,9,9,9,9,9,9,9,9,9,9,9,9,9,9,9,9,9,9,9,9,9,9,9,9,9,9,9,109,111,58,10,10,10,10,10,10,10],
[10,10,10,10,10,10,10,48,112,112,118,11,9,9,9,9,9,9,9,9,9,9,9,9,9,9,9,9,9,119,116,11,9,9,9,9,9,9,109,118,58,10,10,10,10,10,10,10],
[10,10,10,10,10,10,10,48,113,113,112,131,11,9,9,9,119,70,70,70,118,9,9,9,9,9,9,119,70,87,131,118,70,70,70,11,9,119,87,114,58,10,10,10,10,10,10,10],
[10,10,10,10,10,10,10,48,112,131,112,113,118,70,87,118,87,113,112,131,112,118,70,87,118,70,70,87,113,112,112,112,112,113,112,113,70,112,113,111,58,10,10,10,10,10,10,10]]