[[42,42,42,42,42,42,42,42,42,42,42,42,42,42,42,42,42,42,42,42,42,42,42,42,42,42,42,42,42,42,42,42,42,42,42,42,42,42,42,42,42,42,42,42,42,42,42,42],
[42,42,42,42,42,42,42,42,42,42,42,42,42,42,42,42,42,42,42,42,42,42,42,42,42,42,42,42,42,42,42,42,42,42,42,42,42,42,42,42,42,42,42,42,42,42,42,42],
[42,42,42,42,42,42,42,42,42,42,42,42,42,42,42,27,91,91,91,91,91,34,42,42,42,42,42,27,91,91,91,91,91,91,91,91,91,91,91,91,34,42,42,42,42,42,42,42],
[42,42,42,42,42,42,42,42,42,42,42,42,42,42,46,58,108,44,59,44,45,54,42,42,42,42,46,9,9,109,106,44,60,9,9,9,9,9,9,9,56,42,42,42,42,42,42,42],
[42,42,42,42,42,42,42,42,42,42,42,42,42,27,43,107,109,108,109,107,106,60,91,91,91,91,9,9,9,95,108,107,111,60,9,9,14,9,9,9,54,42,42,42,42,42,42,42],
[42,42,42,42,42,42,42,42,42,42,42,42,42,79,68,108,106,107,106,108,107,108,107,109,9,9,9,15,9,9,95,106,109,110,45,9,9,9,9,9,14,34,42,42,42,42,42,42],
[42,42,42,42,42,42,42,42,42,42,42,42,42,79,69,107,106,108,107,106,107,106,70,9,9,9,9,9,9,9,9,84,106,105,106,9,9,9,111,9,9,54,42,42,42,42,42,42],
[42,42,42,42,42,42,42,42,42,42,42,42,42,79,68,109,107,85,96,85,106,96,97,9,13,9,9,9,14,9,9,9,106,109,71,9,9,115,63,9,9,9,34,42,42,42,42,42],
[42,42,42,42,42,27,91,91,91,34,42,42,42,79,69,111,86,9,12,9,9,9,9,9,9,9,9,9,9,9,9,43,106,17,70,9,9,75,76,9,17,9,54,42,42,42,42,42],
[42,42,42,42,46,9,9,9,9,54,42,42,46,109,106,97,9,9,9,9,9,9,9,9,9,9,9,9,9,9,9,68,111,108,109,9,9,9,9,9,9,10,9,34,42,42,42,42],
[42,42,42,27,9,9,9,9,9,9,91,91,9,95,108,9,9,9,9,9,9,9,9,9,9,9,9,9,9,9,9,69,109,110,9,9,9,9,16,9,9,9,9,56,42,42,42,42],
[42,42,42,79,9,9,9,11,9,9,9,9,9,9,9,9,9,9,9,9,9,9,9,9,9,9,9,9,9,9,9,68,108,71,9,9,12,9,9,9,9,9,9,56,42,42,42,42],
[42,42,42,33,35,9,9,9,9,9,9,9,9,9,9,9,11,9,9,9,9,9,13,12,9,9,9,9,11,9,9,95,109,70,9,9,9,9,17,9,9,17,11,56,42,42,42,42],
[42,42,42,42,42,79,9,9,12,9,9,9,14,9,9,9,9,9,9,9,9,9,9,9,9,9,9,9,9,9,9,9,84,108,9,9,9,9,9,9,9,9,9,56,42,42,42,42],
[42,42,42,42,42,79,9,9,9,9,9,9,9,9,9,9,9,9,9,9,9,9,9,9,9,9,9,9,9,9,9,9,9,109,105,9,9,13,9,9,9,9,9,56,42,42,42,42],
[42,42,42,42,42,79,9,9,9,9,9,9,9,9,9,9,9,9,9,15,9,9,9,9,9,9,9,9,9,9,9,9,9,9,9,9,9,9,9,9,17,9,13,54,42,42,42,42],
[42,42,42,42,42,79,9,9,9,9,9,9,9,9,9,9,9,9,9,9,9,9,9,9,9,9,9,9,9,9,9,9,9,9,9,9,9,9,9,9,10,9,9,9,55,91,91,91],
[42,42,42,42,42,79,9,59,59,44,109,9,9,9,9,9,9,9,9,9,9,58,109,9,11,9,9,9,9,13,9,9,9,9,11,9,9,9,9,9,9,81,92,92,104,9,9,11],
[42,42,42,42,42,79,58,110,111,107,110,15,9,9,12,9,9,9,9,9,58,110,70,9,109,59,44,60,9,9,9,9,10,9,9,9,108,9,9,17,9,80,9,9,9,9,9,9],
[42,42,42,42,46,45,109,111,109,106,86,9,9,9,11,9,9,9,9,43,108,85,86,9,95,110,110,71,9,9,9,9,9,9,9,9,111,106,9,9,9,122,9,9,9,9,9,9],
[91,91,91,55,109,108,106,111,106,110,71,9,9,9,9,9,9,9,9,109,97,9,9,9,9,9,108,70,9,9,9,9,9,9,9,9,107,71,9,9,24,25,26,9,9,13,9,9],
[13,109,45,80,109,97,96,85,84,111,70,9,9,9,9,9,9,9,9,9,9,9,9,9,11,9,69,70,9,9,9,9,9,9,9,9,106,109,106,9,9,123,9,9,9,9,9,9],
[9,69,70,101,102,93,9,9,9,95,109,9,9,9,9,9,9,9,9,109,107,9,9,9,9,9,110,109,9,9,9,9,9,9,11,9,95,106,71,9,9,80,9,14,9,9,9,9],
[9,84,110,60,9,94,9,9,9,9,16,9,9,9,9,9,9,9,9,69,71,9,9,9,9,9,9,9,9,9,11,9,9,9,12,9,9,69,109,45,9,80,9,9,9,9,9,9],
[11,9,111,109,9,122,9,16,9,9,9,9,9,9,9,9,12,9,9,68,106,9,9,9,9,9,109,110,9,9,9,9,9,9,9,9,9,69,106,71,9,101,102,93,109,9,12,9],
[9,9,9,9,24,25,26,9,9,15,9,9,10,9,9,9,9,9,9,69,109,9,9,9,9,9,108,71,9,9,9,9,9,9,9,9,9,109,85,110,44,44,109,94,110,45,9,9],
[9,9,9,9,9,123,9,9,9,9,9,9,9,9,9,9,9,9,9,109,110,59,110,9,9,9,110,70,9,9,9,9,9,9,9,9,11,9,9,9,95,108,97,80,85,70,9,9],
[12,9,9,14,9,101,102,93,9,9,9,9,9,9,9,9,9,9,9,9,9,108,69,9,58,107,111,109,9,9,9,9,9,9,9,9,9,9,9,9,9,9,9,80,9,111,9,10],
[9,9,9,9,9,9,9,94,9,9,10,9,9,9,9,15,9,11,9,9,9,9,9,9,109,85,97,9,9,9,9,9,9,9,9,9,9,9,9,12,9,9,11,80,9,9,9,9],
[9,9,9,9,9,9,107,80,9,9,9,9,9,9,9,9,9,9,9,9,9,9,9,9,9,9,9,9,9,9,12,9,9,9,9,9,9,9,9,9,9,9,9,122,9,16,9,9],
[9,9,10,9,9,43,106,101,102,93,9,9,9,9,9,9,9,9,9,9,9,9,9,9,9,9,9,9,9,9,9,9,9,9,9,9,109,60,9,9,11,9,24,25,26,9,9,9],
[9,9,9,9,58,107,108,109,106,94,9,9,11,14,9,9,9,9,9,16,9,9,9,9,9,9,9,9,9,9,9,9,9,9,9,9,106,109,111,45,9,43,109,123,9,9,15,9],
[9,13,9,9,69,109,107,110,70,80,9,9,9,9,9,11,9,9,9,9,9,11,9,10,9,9,9,9,9,9,9,9,9,11,9,9,9,95,106,106,109,110,71,80,9,9,9,9],
[9,9,9,58,108,105,110,18,108,80,9,9,9,9,9,9,9,9,9,9,9,9,9,9,9,9,9,9,9,9,9,109,45,9,9,9,9,9,111,110,113,31,32,80,9,9,9,9],
[9,9,9,109,109,107,109,106,71,80,9,9,9,9,9,10,9,9,15,9,9,9,9,9,9,9,9,9,9,9,58,106,106,9,9,9,9,9,9,95,39,40,41,80,9,9,9,9],
[9,9,9,9,84,106,105,108,70,80,9,9,9,9,9,9,9,11,9,9,9,12,9,9,9,9,9,9,9,108,96,85,108,45,9,9,9,9,9,9,50,51,52,80,9,14,9,13],
[12,9,9,9,9,9,95,85,106,80,9,9,9,12,9,9,9,9,9,9,9,9,10,9,9,9,9,9,28,65,65,35,109,107,60,9,9,14,9,9,106,111,71,80,9,9,9,9],
[9,9,9,9,9,9,9,9,109,80,9,9,9,9,9,9,9,9,9,9,9,9,9,20,9,9,9,28,53,42,42,42,79,111,106,109,9,9,9,9,108,109,70,80,9,9,9,9],
[9,10,9,9,9,9,9,9,9,80,9,9,11,9,14,9,9,9,9,81,92,92,21,22,121,92,92,83,42,42,42,42,79,85,85,97,9,9,16,11,95,106,97,80,9,10,9,9],
[9,9,9,9,9,9,9,9,9,80,9,9,9,9,9,9,9,81,92,104,43,111,108,23,106,110,60,56,42,42,42,42,57,92,92,92,93,9,9,9,9,108,81,104,9,9,9,9],
[9,13,9,9,12,9,9,9,28,66,67,35,9,9,20,9,81,104,106,111,107,106,97,9,9,84,110,54,42,42,42,46,84,96,85,70,94,11,9,20,9,81,104,9,9,9,9,12],
[9,9,9,9,9,9,9,106,54,42,42,42,57,21,22,121,104,106,109,85,96,109,9,9,9,9,107,109,91,91,91,9,9,9,9,97,101,102,21,22,121,104,9,9,14,9,9,9],
[9,9,9,15,9,9,9,95,110,34,42,46,109,9,23,109,85,97,9,9,9,9,9,9,9,9,9,9,9,9,16,9,11,9,9,9,9,9,9,23,9,9,9,9,9,9,9,9],
[9,9,9,9,9,9,9,9,84,110,55,110,97,9,9,9,9,9,9,9,9,9,9,9,12,9,9,10,9,9,9,9,9,9,10,9,9,9,9,9,9,9,9,11,9,16,9,109],
[11,9,9,14,9,9,9,9,81,103,104,109,9,9,11,9,9,9,12,9,9,9,10,9,9,9,9,9,9,43,108,45,9,9,9,9,12,9,9,13,9,9,9,9,9,9,9,69],
[9,16,9,9,9,9,9,9,122,9,9,9,9,9,9,9,9,9,9,9,9,9,11,9,13,9,9,9,58,106,111,106,60,9,9,9,9,9,9,9,9,10,9,9,9,9,58,106],
[9,9,9,10,9,9,12,24,25,26,9,9,9,9,9,10,14,9,13,9,58,106,9,9,9,9,9,43,106,109,105,106,70,9,9,9,9,9,9,9,12,9,9,58,59,44,107,108],
[9,13,9,9,9,9,9,9,123,9,9,11,9,13,9,9,9,9,9,43,109,106,44,109,111,110,106,109,17,106,107,106,111,110,44,108,106,109,45,9,9,43,109,108,109,110,111,109]]