[[108,110,106,71,9,9,9,9,9,9,9,9,9,9,95,84,108,106,107,109,110,111,106,110,109,97,86,9,9,9,9,9,9,69,107,106,108,107,110,107,108,110,106,109,108,111,110,108],
[109,106,107,60,109,9,9,9,9,9,9,15,9,9,9,109,18,96,17,85,108,85,19,106,96,105,9,9,9,11,9,9,9,9,68,109,108,17,107,112,29,30,105,107,18,108,107,111],
[106,111,107,106,70,9,9,9,9,9,9,9,9,9,9,9,9,9,9,9,9,9,9,9,9,9,9,9,9,9,9,9,9,9,109,95,109,108,110,36,37,38,106,108,106,19,106,109],
[96,96,84,110,106,60,9,9,15,9,9,9,11,9,9,9,9,9,10,9,9,9,9,9,9,9,9,9,9,9,9,9,9,9,9,9,84,95,106,47,48,49,111,109,106,107,110,108],
[9,9,9,95,96,109,9,9,9,9,12,9,9,9,9,9,9,9,9,9,9,16,9,9,9,9,9,9,9,9,9,9,9,9,9,9,9,68,110,108,110,108,17,106,110,106,86,28],
[9,9,9,9,9,9,9,9,9,9,9,9,9,9,9,9,9,9,9,9,9,9,15,9,9,9,13,9,9,9,9,9,9,15,9,9,9,69,106,109,106,111,109,107,97,109,28,53],
[9,9,9,9,9,9,9,9,15,9,9,9,9,9,12,9,11,9,9,9,9,9,9,9,9,9,9,9,9,9,15,9,9,9,9,9,9,69,107,110,97,85,96,85,109,28,53,42],
[9,9,15,9,9,9,9,9,9,9,9,9,9,15,9,9,9,9,9,9,9,9,9,9,9,9,9,9,9,9,9,9,9,16,9,9,9,68,86,85,109,28,65,65,65,53,42,42],
[9,9,9,9,9,9,9,9,9,9,9,9,9,9,9,9,9,9,9,9,9,9,15,9,9,9,9,9,9,9,9,9,9,9,9,9,9,84,108,28,65,53,42,42,42,42,42,42],
[9,9,9,9,14,9,9,9,9,9,9,9,9,9,28,65,65,35,9,9,9,9,9,9,9,9,107,9,9,9,9,9,9,9,9,9,9,107,28,53,42,42,42,42,42,42,42,42],
[9,9,9,9,9,9,16,9,9,9,9,28,65,65,53,42,42,42,33,35,108,44,110,59,44,106,107,106,111,9,9,9,9,9,9,9,9,9,56,42,42,42,42,42,42,42,42,42],
[9,9,9,9,9,9,9,9,9,9,9,56,42,42,42,42,42,42,42,46,106,107,109,108,107,110,111,109,107,109,9,17,9,17,9,9,19,9,56,42,42,42,42,42,42,42,42,42],
[9,9,9,9,9,9,9,9,9,9,9,56,42,42,42,42,42,27,91,110,58,110,106,18,111,19,106,108,109,70,13,9,18,9,13,15,9,9,54,42,42,42,42,42,42,42,42,42],
[9,9,9,9,14,9,9,9,15,9,9,56,42,42,42,42,42,79,109,43,108,18,111,105,110,106,110,111,107,110,9,17,9,10,9,19,17,15,9,34,42,42,42,42,42,42,27,91],
[9,9,9,9,9,9,9,9,9,9,9,54,42,42,42,42,42,79,69,107,110,106,110,108,17,109,105,109,110,71,14,9,15,9,18,9,9,9,9,56,42,42,42,42,42,46,109,44],
[9,9,9,9,9,9,9,9,9,14,9,9,91,91,91,91,34,79,105,84,108,111,109,86,96,85,106,106,85,105,9,18,14,17,9,17,9,13,17,56,42,42,42,42,27,43,108,107],
[15,9,9,9,9,9,9,9,9,9,9,9,9,10,9,9,56,33,35,109,96,85,111,97,28,35,95,109,9,9,18,9,9,9,9,9,14,17,9,54,42,42,42,46,109,110,109,108],
[9,17,9,16,9,18,9,9,9,15,9,17,9,9,9,28,53,42,42,33,65,65,65,65,53,42,79,9,16,19,9,10,9,9,9,9,9,9,9,10,91,91,91,43,105,111,107,106],
[9,9,14,18,9,9,16,19,9,9,18,12,9,18,10,56,42,42,42,42,42,42,42,42,42,42,79,9,9,9,9,109,44,59,44,105,9,9,9,9,109,44,108,58,109,108,18,109],
[9,16,9,9,17,9,14,9,15,9,9,17,10,9,9,56,42,42,42,42,42,42,42,42,42,42,79,9,9,9,58,109,108,109,108,110,109,9,18,9,69,18,106,107,17,110,106,107],
[15,9,19,9,9,9,15,9,9,12,9,9,12,9,28,53,42,42,42,42,42,42,42,42,42,42,79,11,9,43,111,109,110,106,111,109,110,9,9,9,68,107,111,109,106,107,109,108],
[105,9,9,19,9,12,9,18,9,14,18,9,19,15,56,42,42,42,42,42,42,42,42,42,42,46,9,9,9,69,108,17,111,18,110,70,9,16,9,9,110,19,97,85,96,95,106,107],
[45,44,108,9,9,9,18,9,12,9,9,12,9,9,56,42,42,42,42,42,42,42,42,42,27,17,9,9,106,110,110,109,110,106,111,97,9,9,109,44,58,108,71,9,13,68,110,109],
[106,109,70,9,9,9,110,9,9,9,9,106,108,28,53,42,42,42,42,42,42,42,42,42,79,105,9,9,58,108,19,106,110,111,97,109,11,9,109,108,109,106,70,16,9,69,108,106],
[18,111,109,9,9,43,68,109,9,11,109,43,28,53,42,42,42,42,42,42,42,42,42,42,79,18,9,9,110,106,109,108,18,109,70,9,9,9,69,107,110,107,110,10,43,58,107,110],
[107,71,9,16,109,109,110,71,9,9,69,108,56,42,42,42,42,42,42,42,42,42,42,42,33,65,35,9,9,95,84,108,106,108,71,9,16,9,68,111,106,109,70,9,110,107,108,109],
[108,70,9,9,69,106,17,70,9,15,95,106,56,42,42,42,42,42,42,27,91,91,34,42,42,42,42,79,14,9,68,108,109,106,70,9,9,109,43,109,108,17,60,44,43,105,106,107],
[17,111,9,9,68,110,111,71,9,9,9,110,56,42,42,42,42,42,46,108,44,109,54,42,42,42,42,79,9,9,111,85,111,108,106,9,9,110,106,111,106,107,106,110,110,109,108,28],
[110,70,14,9,69,105,108,111,107,9,9,107,56,42,42,42,42,27,108,109,107,70,59,91,34,42,42,79,9,9,9,9,111,109,9,14,9,68,108,107,110,108,109,19,106,107,17,56],
[106,71,9,9,68,111,110,19,71,9,9,110,54,42,42,42,46,58,107,110,106,17,109,109,54,42,46,108,9,9,9,16,9,9,9,9,9,69,105,109,106,107,110,107,106,18,105,56],
[107,109,9,16,105,96,108,111,106,16,9,109,107,91,91,91,111,107,19,107,108,106,110,107,44,91,44,110,107,109,9,9,9,9,9,9,109,43,107,111,108,106,109,105,109,110,107,56],
[109,71,9,9,9,9,109,111,9,9,9,69,107,44,44,44,43,107,106,17,18,107,106,18,107,17,106,105,111,110,44,59,44,45,9,9,68,108,110,106,107,19,107,108,110,106,111,56],
[105,70,9,9,9,11,9,9,9,9,43,69,106,109,107,106,108,97,85,85,108,109,108,19,85,19,107,108,106,106,107,109,105,110,13,9,69,17,107,109,111,106,17,107,19,110,109,56],
[106,45,59,109,9,9,9,13,9,9,95,110,107,18,110,109,107,71,9,13,19,106,107,70,16,95,109,105,110,108,17,108,106,70,9,9,110,106,110,106,107,105,108,107,106,106,106,54],
[108,107,111,45,44,108,59,107,9,9,9,9,109,85,111,106,108,45,10,9,108,18,110,97,9,9,84,107,109,105,110,107,109,70,9,9,69,109,18,108,110,109,107,111,110,108,109,106],
[106,109,115,63,108,107,106,70,9,9,9,15,9,9,84,108,18,106,107,109,106,107,97,9,11,15,43,108,106,107,106,108,17,108,9,9,68,108,107,19,106,108,106,109,107,106,105,107],
[105,110,75,76,111,109,110,60,44,59,106,109,9,9,9,69,107,109,106,108,117,90,70,13,9,43,105,110,109,107,106,105,107,70,9,9,107,110,106,107,109,107,110,108,106,109,110,111],
[108,107,111,108,106,18,106,108,106,108,109,110,111,9,16,109,85,96,108,110,98,99,70,9,58,108,106,107,105,111,97,85,96,109,15,9,9,109,110,96,85,108,85,110,85,108,107,106],
[111,106,97,96,111,96,85,106,111,107,17,106,109,9,9,9,9,9,109,85,107,107,60,43,19,106,106,109,107,110,9,9,9,9,9,9,9,9,9,9,9,9,9,9,9,84,106,108],
[106,109,108,9,9,9,9,109,110,96,85,108,9,9,9,13,9,9,9,9,69,106,19,108,106,107,17,111,85,109,9,9,9,9,9,9,16,9,9,9,9,9,9,9,9,9,95,111],
[108,107,71,9,9,9,9,9,9,9,9,9,9,9,9,9,9,9,9,9,84,108,110,106,110,109,106,71,9,9,9,9,13,9,9,9,9,9,9,9,9,9,9,9,9,9,9,84],
[110,111,70,9,9,15,9,9,9,9,9,9,11,9,9,9,9,9,9,9,9,95,110,107,106,85,96,109,9,9,11,9,15,9,9,9,9,9,9,9,9,9,9,9,9,9,9,9],
[107,97,108,9,9,9,9,9,9,9,9,9,9,9,9,9,9,15,9,9,9,9,109,96,110,9,9,9,9,14,9,9,9,9,9,9,9,9,9,9,9,9,9,9,9,9,9,9],
[105,97,9,9,9,9,9,9,9,15,9,9,14,9,9,9,9,9,9,9,9,9,9,9,9,9,9,9,9,9,9,9,9,9,9,9,9,13,9,9,9,9,9,9,9,9,9,9],
[70,9,9,9,9,14,9,9,9,9,9,9,9,9,9,9,9,9,9,9,9,9,9,9,9,9,9,9,9,9,9,9,9,14,9,9,16,9,9,9,9,9,9,9,9,9,9,9],
[108,9,9,9,9,9,9,9,9,9,9,9,9,9,15,9,9,9,9,9,16,9,9,9,9,9,9,9,9,9,9,9,9,9,9,9,9,9,9,9,9,9,9,9,9,9,9,9],
[9,9,9,9,9,9,9,9,9,9,15,9,9,9,9,9,9,9,9,9,9,9,9,9,9,9,15,11,9,9,9,9,9,9,9,9,9,9,9,9,9,9,9,9,9,9,9,9],
[9,9,9,9,9,9,9,9,9,9,9,9,9,9,9,9,9,9,9,9,9,9,9,9,9,9,9,9,9,9,9,13,9,9,9,9,9,9,9,9,9,9,9,9,9,9,9,9]]