[[112,112,113,112,112,116,116,113,114,110,9,9,9,9,9,45,113,114,131,9,9,117,112,113,112,115,116,113,111,9,58,10,10,10,10,10,10,10,10,10,10,10,10,10,10,10,10,10],
[115,112,116,113,112,113,116,112,132,9,9,9,9,9,9,44,133,110,9,9,9,109,115,116,112,113,112,115,111,9,58,10,10,10,10,10,10,10,10,10,10,10,10,10,10,10,10,10],
[112,112,112,116,112,112,112,115,114,9,9,15,9,9,9,78,55,9,9,9,9,109,112,114,117,112,112,114,133,9,58,10,10,10,10,10,10,10,10,10,10,10,10,10,10,10,10,10],
[115,113,114,108,108,108,108,133,9,9,9,9,9,9,9,9,44,9,9,9,9,120,132,9,133,117,116,111,9,9,58,10,10,10,10,10,10,10,10,10,10,10,10,10,10,10,10,10],
[116,112,111,9,9,9,9,9,9,9,9,9,9,16,9,9,45,131,9,9,9,9,9,9,9,120,117,111,9,59,34,10,10,10,10,10,10,10,10,10,10,10,10,10,10,10,10,10],
[116,112,111,9,9,9,9,9,9,9,9,9,9,9,9,9,44,120,117,131,9,9,9,9,9,9,132,111,9,58,10,10,10,10,10,10,10,10,10,10,10,10,10,10,10,10,10,10],
[112,115,111,9,132,9,9,9,9,9,9,9,9,9,15,9,78,55,132,9,9,9,9,9,9,9,131,110,9,58,10,10,10,10,10,10,10,10,10,10,36,63,63,63,33,10,10,10],
[115,113,112,118,9,9,9,9,9,9,9,9,9,9,9,9,19,20,9,9,9,9,9,9,9,9,15,9,9,58,10,10,10,10,10,10,10,10,10,10,48,128,85,86,62,33,10,10],
[116,113,112,111,9,9,9,9,9,9,9,9,9,9,9,9,22,23,24,9,9,9,9,9,9,16,9,16,9,62,63,63,63,63,33,10,10,10,10,10,48,93,94,95,133,62,33,10],
[113,116,112,131,9,9,9,9,9,9,9,9,9,9,9,9,28,29,9,9,9,9,87,70,131,9,9,9,9,9,9,9,9,113,58,10,10,10,10,10,48,99,100,101,118,11,58,10],
[113,115,114,9,9,9,9,9,9,9,9,9,9,9,9,15,9,45,9,9,9,132,112,115,113,118,9,9,9,9,116,131,87,118,62,33,10,10,10,10,48,131,108,108,117,113,58,10],
[112,132,9,9,9,9,9,9,9,9,9,9,9,9,131,113,133,44,11,9,9,9,120,113,116,112,11,9,9,9,120,117,115,112,112,58,10,10,10,10,35,18,18,60,120,132,58,10],
[115,111,9,9,15,9,9,9,9,9,9,9,9,113,114,110,43,71,111,9,9,9,9,109,115,113,118,132,9,9,9,120,117,116,114,58,10,10,10,10,10,10,10,10,18,18,34,10],
[113,111,9,9,9,9,9,9,9,9,9,9,132,115,114,43,71,132,110,9,9,9,9,109,113,116,112,118,133,9,9,9,131,112,111,58,10,10,10,10,10,10,10,10,10,10,10,10],
[112,111,9,9,9,9,9,9,9,9,113,87,113,112,110,44,9,9,9,9,9,9,132,87,112,112,115,113,111,9,9,9,114,117,111,62,33,10,10,10,10,10,10,10,10,10,10,10],
[118,9,9,16,9,9,9,9,9,87,113,115,114,110,43,71,11,9,9,9,9,131,87,116,113,116,113,112,111,9,9,9,133,9,132,11,62,33,10,10,10,10,10,10,10,10,10,10],
[112,118,9,9,9,9,9,9,9,123,116,110,43,56,71,113,118,133,9,9,9,120,117,115,112,113,116,115,111,9,9,9,9,9,9,117,118,62,63,63,63,63,63,33,10,10,10,10],
[113,111,9,9,9,9,9,9,9,9,131,43,71,112,115,132,9,9,9,9,9,9,9,120,114,108,108,108,113,118,9,9,9,9,9,9,113,112,132,9,9,9,9,58,10,10,10,10],
[131,110,9,9,9,9,9,9,9,43,57,71,120,108,117,9,9,9,9,9,9,9,9,9,133,9,9,9,114,133,9,9,9,9,9,9,133,110,9,9,9,9,9,58,10,10,36,63],
[57,56,55,9,9,21,9,9,9,44,9,9,9,9,9,9,9,119,132,70,70,118,9,16,9,9,9,9,9,9,9,9,9,9,9,9,9,9,9,9,112,115,11,62,63,63,61,131],
[70,11,78,56,25,26,27,56,57,71,9,9,9,9,9,9,9,112,113,112,113,112,133,9,15,9,9,9,9,9,9,9,9,9,9,9,9,9,9,133,116,113,112,116,113,112,112,112],
[115,113,115,131,30,31,32,115,116,112,9,9,9,9,9,9,9,132,112,113,116,112,111,9,9,9,112,115,9,9,9,9,9,9,9,9,9,9,9,132,108,108,112,116,113,115,131,116],
[113,116,111,9,9,9,131,113,112,111,9,9,9,9,133,115,112,87,113,112,112,132,9,9,9,113,114,131,9,9,9,9,9,9,9,9,9,9,9,9,9,9,117,108,108,117,112,112],
[112,115,111,9,9,9,9,120,114,9,9,9,9,87,112,112,113,116,112,116,114,110,9,9,9,116,132,9,9,9,9,9,9,9,9,9,9,9,9,9,9,9,9,9,9,109,112,113],
[112,113,111,9,9,9,9,9,9,9,9,9,9,109,113,116,112,112,114,133,110,9,9,9,9,9,9,9,9,9,9,9,9,9,9,9,9,9,9,9,9,9,9,9,9,133,112,116],
[113,116,132,11,9,9,9,9,9,9,132,9,9,133,117,112,113,112,111,9,9,9,9,9,9,9,9,9,9,9,9,9,9,9,9,9,9,9,9,9,9,9,9,9,9,109,112,116],
[115,112,116,111,9,9,9,87,132,118,9,9,9,9,120,117,112,113,111,9,9,9,9,9,9,9,9,9,9,9,9,9,9,9,9,9,9,9,9,9,9,9,9,9,87,112,112,112],
[112,114,114,133,9,9,87,112,112,112,118,9,9,9,9,9,133,112,118,9,9,9,9,9,9,9,9,9,9,9,9,9,9,9,9,9,9,9,9,9,9,132,70,87,132,112,115,112],
[133,110,9,9,9,9,132,113,115,113,116,118,9,9,9,9,9,117,114,9,9,9,9,9,9,9,9,9,9,9,9,9,9,9,9,9,9,9,9,9,9,109,112,113,112,112,112,115],
[9,9,9,9,9,119,115,112,115,112,115,132,118,133,9,9,9,109,111,9,9,9,9,9,9,9,9,9,9,9,9,9,9,9,9,9,9,9,9,9,9,133,112,113,116,132,115,132],
[9,9,9,9,119,87,112,113,131,112,116,113,112,112,111,9,9,133,118,132,9,9,9,9,9,9,9,9,9,9,9,9,9,9,9,9,9,9,9,9,9,9,117,133,112,115,131,116],
[9,9,9,9,109,112,115,112,116,113,115,112,116,132,111,9,9,120,117,111,9,9,9,9,9,9,9,9,9,9,9,9,9,9,9,9,9,9,9,9,9,9,9,109,113,115,112,112],
[9,15,9,9,109,112,112,115,132,116,113,115,113,112,111,9,9,9,109,111,9,9,9,9,9,9,9,9,9,9,9,9,9,9,9,9,9,9,9,9,9,9,9,109,112,113,116,112],
[9,9,9,9,117,131,116,112,112,113,112,112,131,113,118,9,9,9,120,131,9,9,9,9,9,9,9,9,9,9,9,9,9,9,9,9,9,9,9,9,9,9,119,87,112,112,132,112],
[9,9,9,9,9,117,117,113,115,132,116,112,116,112,114,9,9,9,15,9,9,9,9,9,9,9,9,9,9,9,9,9,9,9,9,9,9,9,9,9,9,9,131,117,112,113,112,115],
[9,9,9,9,9,9,112,117,113,112,112,113,115,112,111,9,9,9,9,16,9,9,9,9,9,9,9,9,9,9,9,9,9,9,9,9,9,9,9,9,9,9,9,109,115,112,115,112],
[9,9,9,9,9,9,9,112,115,113,116,112,114,110,9,9,9,9,116,132,9,9,9,9,9,9,9,9,9,9,9,9,9,9,9,9,9,9,9,9,9,9,9,109,112,113,116,113],
[9,9,9,9,9,9,9,132,116,112,112,114,132,9,9,9,9,87,113,111,9,9,9,9,9,9,9,9,9,9,9,9,9,9,9,9,9,9,9,9,9,9,9,109,112,115,113,113],
[9,9,9,9,9,9,9,115,108,116,108,131,9,9,9,9,109,113,113,111,9,9,9,9,9,9,9,9,9,9,9,9,9,9,9,9,9,9,9,9,9,9,9,109,112,115,113,112],
[9,9,9,9,9,9,9,9,9,9,9,9,9,9,9,131,109,112,115,111,9,9,9,9,9,9,9,9,9,9,9,9,9,9,9,9,9,9,9,9,9,9,119,87,115,115,133,112],
[9,9,9,9,9,9,9,14,9,9,9,9,9,9,9,87,113,116,115,118,131,9,9,9,9,9,9,9,9,9,9,9,9,9,9,9,9,9,9,9,9,132,112,112,113,115,112,116],
[9,9,9,9,9,9,9,9,9,15,9,9,9,9,133,112,115,112,113,112,111,9,9,9,9,9,9,9,9,9,9,9,9,9,9,9,9,9,9,9,9,109,112,112,133,116,131,112],
[9,9,9,9,9,15,9,9,9,9,9,9,9,87,112,113,115,116,112,113,111,9,9,9,9,9,9,9,9,9,9,9,9,9,9,9,9,9,9,9,133,112,112,115,113,115,113,112],
[9,9,9,9,9,9,9,9,9,9,9,119,133,112,116,112,112,116,113,115,118,9,9,9,9,9,9,9,9,9,9,9,9,9,9,9,9,9,9,9,109,112,116,115,112,112,133,112],
[9,9,9,9,119,70,131,9,9,9,119,87,112,113,112,115,112,115,112,116,131,11,9,9,9,9,9,9,9,9,9,9,9,9,9,9,9,9,9,9,109,112,112,112,113,116,113,115],
[9,9,9,9,87,116,118,132,70,70,87,115,116,115,113,116,115,113,116,115,113,111,9,9,9,9,9,9,87,131,118,70,11,9,9,9,9,9,9,9,109,112,131,133,112,112,115,112],
[112,132,11,9,117,116,113,112,115,116,115,116,112,112,116,112,115,112,112,116,113,115,118,70,70,70,70,87,112,112,112,112,118,70,70,133,118,70,70,119,87,112,112,112,116,115,112,112],
[115,113,118,70,132,112,115,115,113,116,112,112,113,115,112,113,112,113,116,115,112,113,112,112,115,112,112,112,115,112,116,115,112,113,112,112,131,116,112,112,113,112,115,113,112,115,112,112]]