[[10,48,113,11,9,9,9,9,109,113,58,10,10,10,10,10,10,10,10,10,10,10,10,10,10,10,10,10,10,10,10,10,10,10,10,10,35,18,60,115,112,11,9,9,120,113,115,112],
[10,35,60,112,11,9,9,119,87,115,62,63,63,33,10,10,10,10,10,10,10,10,10,10,10,10,10,10,10,10,10,10,10,10,10,10,10,10,35,60,116,132,9,9,9,9,120,113],
[10,10,48,115,116,9,9,120,117,112,113,116,115,62,33,10,10,10,10,10,10,10,10,10,10,10,10,10,10,10,10,10,10,10,10,10,10,10,10,48,9,9,9,9,9,9,9,115],
[63,63,61,113,110,9,9,9,120,116,110,120,116,113,58,10,10,10,10,10,10,10,10,10,10,10,10,10,10,10,10,10,10,10,10,10,36,63,63,61,116,132,9,9,9,9,9,109],
[112,113,115,110,9,9,9,9,9,9,9,9,9,9,58,10,10,10,10,10,10,10,10,10,36,63,63,63,33,10,10,10,10,10,10,10,48,116,9,113,115,116,9,9,9,9,9,116],
[116,9,117,131,9,9,9,9,9,9,9,123,9,9,62,63,63,33,10,10,10,10,10,10,61,121,122,133,62,33,10,10,10,10,36,63,61,113,117,110,9,133,9,9,9,9,9,109],
[110,9,9,9,9,9,9,9,9,9,9,9,132,117,116,115,112,58,10,10,10,10,10,48,131,41,42,131,132,58,10,10,10,10,48,116,112,115,116,9,9,9,9,9,9,9,115,113],
[11,9,9,9,9,9,9,9,9,9,9,9,9,131,110,120,113,58,10,10,10,10,10,48,132,133,132,132,59,34,10,10,10,10,35,18,18,60,113,131,9,9,9,9,133,116,112,118],
[116,118,9,9,9,9,9,9,9,9,9,9,9,9,9,9,9,58,10,10,10,10,10,35,60,131,59,18,34,10,10,10,10,10,10,10,10,48,9,9,9,9,9,9,109,115,116,115],
[87,112,115,9,9,9,9,9,9,9,9,9,9,9,9,9,116,62,33,10,10,10,10,10,35,18,34,10,10,10,10,10,10,10,10,10,10,48,116,9,9,9,9,9,120,113,113,112],
[112,113,103,116,9,9,9,9,9,9,9,9,9,9,117,9,115,113,58,10,10,10,10,10,10,10,10,10,10,10,10,10,10,10,10,10,36,61,112,133,9,9,9,9,119,115,87,113],
[114,106,115,110,9,9,9,9,9,9,9,9,9,119,87,118,112,59,34,10,10,10,10,10,10,10,10,10,10,10,10,10,10,10,10,10,48,116,113,9,9,9,9,9,116,114,117,115],
[113,112,114,9,9,9,9,9,9,9,9,9,9,116,115,117,113,58,10,10,10,10,10,10,10,10,10,10,10,10,10,10,36,63,33,10,48,116,11,9,9,9,132,9,133,9,120,116],
[112,9,9,9,9,9,9,123,11,9,9,9,9,131,117,112,115,62,33,10,10,10,10,10,10,10,10,10,10,10,10,10,48,116,58,10,48,112,116,9,9,9,9,9,9,9,9,109],
[110,9,9,9,9,124,132,116,131,9,9,9,9,9,120,113,116,131,58,10,10,10,10,10,10,10,10,10,10,10,36,63,61,113,62,63,61,113,9,9,9,9,9,9,9,119,115,113],
[9,9,9,9,116,131,9,133,9,9,9,9,133,9,9,43,80,76,77,10,10,10,10,10,10,10,10,10,10,10,48,113,112,110,115,9,116,108,133,9,9,9,9,9,132,112,113,112],
[9,9,9,9,133,110,9,9,9,9,9,9,9,9,9,20,132,133,82,10,10,10,10,10,10,10,10,10,10,10,48,9,9,9,123,9,131,132,9,9,9,9,9,9,131,115,113,116],
[9,9,9,9,9,9,9,9,9,9,9,9,9,9,22,23,24,9,62,63,63,63,33,10,10,10,10,10,10,10,48,9,9,9,9,9,9,9,9,9,9,9,9,9,9,9,120,115],
[9,9,9,9,9,9,9,9,9,9,9,9,9,9,9,29,9,9,9,116,121,112,58,10,10,10,10,36,63,63,61,9,118,131,9,9,9,9,9,9,9,9,9,9,9,9,9,113],
[9,9,9,9,9,9,9,9,9,9,133,70,9,9,131,72,9,9,9,132,108,115,62,63,63,63,63,61,9,9,9,9,114,133,9,9,9,9,9,9,9,9,9,9,119,116,9,114],
[9,9,9,9,9,9,9,9,9,9,117,116,115,116,132,73,9,9,9,9,9,9,9,9,9,9,9,9,9,9,9,9,132,9,9,9,9,9,9,9,9,9,9,116,87,111,9,109],
[9,9,9,9,9,9,9,9,9,9,115,43,79,57,56,71,133,9,9,9,9,9,9,9,9,9,9,9,9,9,9,9,9,9,9,9,9,9,9,9,9,9,9,109,115,118,70,116],
[9,9,9,9,9,9,9,131,9,16,43,71,116,112,113,131,114,132,9,9,9,9,9,9,9,9,9,9,9,9,9,9,9,9,9,9,9,9,9,9,9,9,9,112,113,117,113,112],
[9,9,9,132,9,9,9,9,9,9,45,113,114,110,9,9,133,9,9,9,9,9,9,9,9,9,9,9,9,9,9,9,9,9,9,9,9,9,9,9,9,9,9,109,112,116,114,108],
[9,9,9,9,112,133,9,9,43,56,71,9,9,9,9,9,9,9,9,9,9,9,9,9,9,9,9,9,9,9,9,9,9,9,9,9,9,9,9,9,9,9,9,131,116,108,110,9],
[9,9,132,112,115,116,21,9,44,115,9,9,9,9,9,9,9,9,9,9,9,9,9,9,9,9,9,9,9,9,9,9,9,9,9,9,9,9,9,9,9,9,9,9,9,9,9,113],
[9,9,87,116,43,25,26,27,71,116,132,9,9,9,9,9,9,9,9,9,9,9,9,9,9,9,9,9,9,9,9,9,9,9,9,9,9,9,9,9,9,9,132,9,9,9,116,114],
[9,120,116,43,71,112,31,9,116,113,111,9,9,9,9,9,9,9,9,9,9,9,9,9,9,9,9,9,9,9,9,9,9,9,9,9,9,9,9,9,9,9,9,125,102,9,120,115],
[132,9,115,72,113,110,9,9,132,116,133,9,9,9,9,9,9,9,9,9,9,9,9,9,9,9,9,9,9,9,9,9,9,9,9,9,9,9,9,9,9,9,9,104,105,9,9,112],
[116,9,113,45,116,114,9,9,9,9,9,9,9,9,9,9,9,9,9,9,9,9,9,9,9,9,9,9,9,9,9,9,9,9,9,9,9,9,9,9,9,9,9,9,9,9,119,113],
[56,57,56,71,115,9,9,9,9,9,9,9,9,9,9,9,9,9,9,9,9,9,9,9,9,9,9,9,9,9,9,9,9,9,9,9,9,9,9,9,9,9,9,9,9,119,116,115],
[115,9,112,116,123,9,9,9,9,9,9,129,37,38,9,9,9,9,9,9,9,9,9,9,9,9,9,9,9,9,9,9,9,9,131,116,11,9,9,9,9,9,9,9,112,115,118,113],
[118,9,9,132,9,9,9,9,9,9,9,49,50,51,9,9,9,9,9,9,9,9,9,9,9,9,9,9,9,9,9,9,9,9,109,103,115,9,9,9,9,9,9,9,120,113,116,114],
[110,9,9,9,9,9,9,9,9,9,9,64,65,66,9,9,9,9,9,9,9,9,9,9,9,9,9,9,9,9,9,9,9,9,132,108,110,9,9,9,9,9,9,9,9,115,112,113],
[9,9,9,9,9,9,9,131,124,9,9,9,9,9,13,9,9,9,9,9,9,9,9,9,9,9,9,9,9,9,9,9,9,9,9,9,9,9,9,9,9,9,9,17,9,9,116,115],
[9,9,9,9,9,9,9,119,11,133,9,9,9,9,9,9,9,9,9,9,14,9,9,133,11,9,9,9,9,9,9,9,9,9,9,9,9,9,9,9,9,9,9,9,9,9,120,116],
[9,9,9,9,9,9,9,119,118,70,70,131,9,9,9,9,9,9,9,9,9,132,70,87,118,70,116,70,11,9,9,9,9,9,9,9,9,9,9,9,9,132,112,9,9,9,9,113],
[9,9,9,9,9,9,9,115,114,117,115,111,9,9,9,9,113,9,9,9,9,133,112,108,117,113,112,115,111,9,9,9,9,9,9,9,9,9,9,9,9,109,118,116,9,132,116,118],
[9,9,9,9,9,9,9,131,110,120,116,133,9,9,9,116,115,116,11,9,9,9,9,9,113,115,132,116,118,70,133,9,9,9,9,9,9,9,9,9,119,87,114,110,9,9,113,115],
[9,9,9,9,9,9,9,9,9,9,9,9,9,70,70,87,113,112,118,11,9,9,9,9,120,112,113,133,117,112,116,9,9,9,9,9,9,9,16,9,109,114,110,9,9,9,112,116],
[9,9,9,9,9,9,9,9,9,9,9,109,112,113,112,115,116,115,114,110,9,9,9,9,9,120,87,112,118,113,111,9,9,9,9,9,9,9,9,9,131,132,9,9,9,9,120,113],
[9,9,9,9,9,9,9,9,9,9,9,131,113,115,114,116,117,113,118,9,9,9,9,9,9,9,116,122,132,114,131,9,9,9,9,9,9,15,9,9,9,9,9,9,9,9,119,112],
[9,126,103,9,9,9,9,9,9,9,9,120,116,108,110,9,120,133,110,9,9,9,9,9,9,119,113,116,115,111,9,9,9,9,9,9,9,9,9,9,9,9,9,9,9,9,115,116],
[9,106,107,132,9,9,9,9,9,9,9,9,9,9,9,9,9,9,9,9,9,9,9,9,9,133,116,133,132,118,70,115,70,11,9,9,9,9,9,9,9,9,9,9,9,9,116,115],
[9,131,115,9,9,9,9,131,9,9,9,9,9,9,9,9,9,9,9,133,9,9,9,9,9,112,124,115,113,116,115,112,116,118,70,11,131,9,9,9,9,9,9,9,9,112,113,116],
[115,11,9,9,9,119,113,9,9,9,9,119,113,11,9,9,9,9,119,87,113,70,115,9,119,131,112,116,112,133,123,116,113,115,112,116,110,9,9,9,9,9,9,9,119,113,114,118],
[113,122,116,70,70,112,115,11,9,9,119,115,116,112,11,9,119,112,113,115,112,116,132,113,133,116,113,115,117,115,112,115,112,124,115,118,70,11,9,9,115,11,119,113,116,118,115,112],
[132,117,113,115,116,118,113,117,112,70,113,116,118,115,114,117,113,115,116,112,115,113,122,116,115,112,132,116,112,113,116,87,132,116,133,112,115,118,11,119,113,115,116,114,112,115,116,113]]