[[123,113,115,112,116,124,115,110,9,9,9,9,9,9,9,9,9,9,9,9,9,9,109,116,123,113,118,112,116,114,113,115,112,114,110,9,9,9,9,9,9,9,9,9,9,9,9,9],
[112,113,104,113,113,108,133,9,9,9,9,9,9,9,9,9,9,9,9,9,9,9,109,115,114,116,112,113,115,113,112,114,108,131,9,9,9,9,9,9,9,9,9,9,9,9,9,9],
[117,113,115,116,110,9,9,9,9,9,9,9,9,9,9,9,9,9,9,9,9,9,120,117,112,113,115,104,112,117,116,111,9,9,9,9,9,9,9,9,9,9,9,9,9,9,9,9],
[113,114,110,9,9,9,9,9,9,9,9,9,9,9,9,9,9,9,9,9,9,9,9,109,115,118,116,113,114,108,108,132,9,9,9,9,9,9,9,9,9,9,9,9,9,9,9,9],
[112,116,113,70,11,9,9,9,9,9,9,9,9,9,9,132,9,9,9,9,9,9,9,132,108,108,108,117,111,123,9,9,9,9,9,9,131,9,9,9,9,9,9,9,9,9,9,9],
[106,113,115,113,115,9,9,9,9,9,9,9,9,9,9,9,9,9,9,9,9,9,9,9,9,9,9,133,110,9,9,9,9,9,9,9,9,9,9,132,9,9,9,9,9,9,9,9],
[115,113,105,112,131,9,9,9,9,9,9,9,121,122,9,9,9,9,9,9,9,9,9,9,9,9,9,9,9,9,9,9,9,9,9,9,133,9,9,9,9,9,9,9,9,9,9,9],
[118,87,113,110,9,9,9,9,9,9,9,9,41,42,9,9,9,9,9,9,9,9,9,9,9,9,9,9,9,9,9,9,9,9,9,9,9,9,9,9,119,115,132,9,9,9,9,9],
[113,112,111,9,9,127,83,84,9,15,9,9,9,9,9,9,9,9,9,9,9,9,9,9,9,9,9,9,9,9,9,9,9,9,9,9,9,9,133,70,116,113,111,9,9,9,9,9],
[122,113,110,9,9,90,91,92,9,9,9,9,9,9,9,9,9,9,9,9,9,9,9,9,9,9,9,9,9,9,9,9,9,9,9,9,9,119,113,116,115,118,116,113,9,9,9,9],
[113,116,9,9,9,96,97,98,9,9,9,131,9,9,9,9,9,9,9,9,9,9,9,9,13,9,9,9,9,9,9,9,9,9,9,131,70,116,112,128,85,86,116,115,116,131,9,9],
[115,113,113,9,9,9,9,9,9,9,9,9,9,9,9,9,9,9,9,9,9,9,9,9,9,9,9,9,9,9,9,9,9,9,9,113,115,118,115,93,94,95,113,122,118,115,9,9],
[64,113,112,11,9,9,9,9,9,9,9,9,9,9,9,9,9,9,9,9,9,9,9,9,9,9,9,9,9,9,9,9,9,9,9,120,116,121,116,99,100,101,115,116,113,116,9,9],
[116,112,87,116,112,9,9,9,9,9,9,9,9,9,9,9,9,9,9,9,133,9,9,9,9,9,9,131,9,9,9,9,9,9,9,9,120,115,112,115,116,114,112,110,115,132,9,9],
[113,113,125,115,110,9,9,9,9,9,9,9,9,9,9,9,9,9,9,9,9,9,9,9,9,9,9,9,9,9,9,9,9,9,9,9,9,109,113,118,123,113,116,9,9,9,9,9],
[87,112,116,116,132,9,9,133,9,9,9,9,9,9,131,9,119,132,9,9,9,9,9,9,9,9,9,9,9,9,9,9,9,9,9,9,119,87,111,108,116,110,9,9,9,9,9,9],
[113,113,112,9,9,9,9,125,102,17,9,132,9,9,119,116,109,118,9,9,9,9,9,9,9,9,9,9,9,9,9,9,9,9,9,9,132,108,110,9,9,9,9,9,132,9,9,9],
[114,115,116,9,9,9,9,104,105,9,9,9,9,9,115,113,112,115,11,9,9,9,9,9,9,9,9,9,9,17,9,9,9,9,9,9,9,9,9,9,9,9,9,9,9,9,9,9],
[116,42,116,9,9,9,9,9,13,9,9,9,9,9,113,121,122,116,115,9,9,9,9,9,9,9,9,9,9,9,9,9,9,9,9,9,9,9,9,9,9,9,9,15,9,9,9,9],
[117,116,112,9,9,9,9,9,9,9,9,9,9,9,116,41,42,113,110,9,9,9,9,9,9,9,9,9,9,9,9,9,9,9,9,9,9,9,9,9,9,9,9,9,9,9,9,9],
[112,123,116,115,116,112,9,9,9,9,9,9,9,9,115,112,115,116,9,9,9,9,9,9,9,9,132,9,9,9,9,9,9,9,9,9,9,9,9,9,9,9,9,9,9,9,9,119],
[116,116,127,83,84,113,116,9,9,9,9,9,9,9,9,113,112,9,9,9,9,9,9,9,9,9,9,9,9,9,9,9,9,9,9,9,9,9,9,9,9,9,9,9,9,9,131,113],
[124,113,90,91,92,116,115,9,9,9,9,9,9,9,9,9,9,9,9,9,9,9,9,9,9,9,9,9,9,9,9,9,9,131,9,9,9,9,9,9,9,9,9,9,9,9,115,118],
[116,116,96,97,98,112,9,9,9,9,9,9,9,9,9,9,9,9,9,9,9,9,9,9,9,9,9,9,9,9,9,9,9,9,9,9,9,9,9,9,14,9,9,9,9,9,116,115],
[115,104,116,114,122,113,9,9,9,128,85,86,9,9,9,9,9,9,9,9,9,9,115,15,9,9,9,9,9,9,9,9,9,9,9,9,9,9,9,9,9,9,9,9,9,119,112,123],
[116,117,121,116,113,115,9,9,9,93,94,95,9,9,9,9,9,9,9,9,9,126,103,9,9,9,9,9,9,9,9,9,9,9,9,9,9,9,9,9,9,9,9,9,9,115,115,113],
[123,116,113,9,9,9,9,9,9,99,100,101,9,9,9,9,9,9,9,9,17,106,107,9,9,123,9,9,9,9,9,9,9,9,9,9,9,9,9,9,9,9,9,9,119,115,124,116],
[114,115,116,9,9,9,9,9,9,9,123,9,9,9,9,115,113,9,9,9,9,131,132,9,9,133,9,9,9,9,9,9,9,9,9,9,9,9,9,9,9,9,9,9,115,116,113,115],
[113,124,112,9,9,9,9,9,9,9,9,9,9,9,17,112,123,9,9,9,9,9,9,9,9,9,9,9,9,9,9,9,9,9,9,9,9,9,9,9,9,9,9,119,112,118,115,87],
[112,116,115,9,9,9,9,9,9,9,9,9,9,9,9,9,115,116,9,9,9,9,9,9,9,9,9,9,9,9,9,9,9,9,9,9,9,9,9,9,9,116,115,113,116,115,105,113],
[121,116,9,9,9,9,9,9,9,9,9,9,119,115,113,9,9,9,9,9,9,9,9,9,9,9,9,132,9,9,9,9,9,9,9,13,9,9,9,9,9,115,116,87,106,112,115,112],
[116,110,9,9,9,9,9,9,9,9,113,115,113,116,115,112,9,9,9,9,9,9,9,9,113,116,115,112,9,9,9,17,9,9,9,9,9,9,9,9,9,120,113,115,116,114,113,116],
[9,9,9,9,9,9,9,9,9,9,116,117,130,39,40,115,9,9,9,9,9,121,122,9,112,104,123,111,9,9,9,9,9,9,9,9,131,9,9,9,9,9,9,109,115,113,115,114],
[9,9,9,9,9,9,9,9,9,9,112,113,52,53,54,112,11,9,9,9,9,41,42,9,113,124,112,115,11,9,132,9,9,9,9,9,9,9,9,9,9,9,9,109,112,116,114,115],
[9,9,9,9,9,9,9,9,9,9,116,115,67,68,69,115,124,131,9,9,9,9,9,9,115,112,126,113,116,9,9,9,9,9,9,14,9,9,9,9,9,9,9,112,115,87,115,87],
[9,9,9,9,113,115,132,9,9,9,9,120,116,115,112,115,110,9,9,9,9,9,9,9,9,113,115,112,132,9,9,9,9,9,9,9,9,9,9,9,9,9,119,114,113,116,113,115],
[9,9,9,119,115,104,116,9,9,9,9,9,120,116,110,9,9,9,9,9,9,9,9,9,9,16,9,9,9,9,9,9,9,9,9,9,9,9,9,9,119,112,115,116,115,121,115,116],
[9,9,116,112,124,115,131,115,9,9,9,9,9,9,9,9,9,9,9,9,9,9,9,9,9,9,9,9,9,9,9,9,9,9,9,9,15,9,9,9,113,116,118,115,112,115,42,115],
[9,9,109,125,115,103,115,113,9,9,9,9,9,9,9,9,9,9,9,9,9,9,9,9,9,9,9,9,9,9,9,9,9,9,9,9,9,9,9,9,9,120,112,113,123,112,115,118],
[9,9,120,115,113,116,114,115,9,9,9,9,9,9,9,9,9,9,9,9,9,9,9,9,9,9,9,9,9,9,9,9,9,9,9,9,9,9,9,9,9,9,120,115,114,116,87,113],
[9,9,9,9,129,37,38,112,132,9,9,9,9,9,9,9,9,9,9,9,9,9,9,9,9,9,9,9,9,9,9,9,9,9,9,9,9,9,9,9,9,9,9,116,115,113,112,116],
[9,9,9,9,49,50,51,123,116,9,9,9,9,9,9,9,9,9,9,9,9,9,9,9,9,9,9,9,9,9,9,9,9,9,9,9,9,9,9,9,9,9,9,9,120,115,115,124],
[9,9,9,9,64,65,66,115,110,9,9,9,9,9,9,9,9,9,9,9,9,9,9,9,9,9,9,9,9,9,9,9,9,9,9,9,9,9,9,9,9,9,9,9,9,109,116,113],
[9,9,9,9,113,115,112,116,9,9,9,9,9,9,9,121,122,116,9,9,9,9,9,9,9,9,9,9,9,9,9,9,9,9,9,9,9,9,9,9,9,9,9,9,9,112,113,112],
[9,9,9,9,9,9,9,9,9,9,9,9,9,9,9,9,14,123,9,9,9,9,9,9,9,9,9,9,9,9,9,9,9,9,9,9,9,9,9,9,9,9,9,9,119,115,66,116],
[70,11,9,9,9,9,9,9,9,9,9,9,9,9,9,9,9,9,9,9,9,9,9,9,9,9,9,9,9,9,9,9,9,9,9,9,9,116,11,9,9,119,70,116,112,116,115,115],
[116,114,115,11,9,9,9,9,9,9,9,9,9,9,9,9,9,9,9,9,9,9,9,9,9,9,9,9,9,9,9,116,9,119,112,119,112,113,115,11,9,109,115,113,115,87,124,113],
[87,123,113,116,113,115,112,114,116,113,115,112,114,115,112,115,117,116,112,115,116,113,115,112,117,112,115,116,118,115,113,115,112,115,115,113,115,112,113,115,116,113,118,115,64,116,112,118]]