[[10,10,10,10,10,10,10,10,10,10,10,10,10,10,10,48,9,9,9,9,9,9,9,9,9,9,9,9,9,9,9,9,9,117,112,113,112,112,113,112,115,113,112,115,112,113,115,112],
[10,10,10,10,10,10,10,10,10,10,10,10,10,10,10,48,9,9,9,9,9,9,9,9,9,9,9,9,9,9,9,9,9,132,108,117,114,108,108,117,115,112,113,112,128,85,86,133],
[10,10,10,10,10,10,10,10,10,10,10,10,10,10,10,48,9,9,9,9,9,9,9,9,9,9,9,9,9,9,9,9,9,9,9,9,9,9,9,120,133,112,113,112,93,94,95,112],
[10,10,10,10,10,10,10,10,10,10,10,10,10,10,10,48,9,9,9,9,9,9,9,9,9,9,9,9,9,9,9,9,9,9,9,9,9,9,9,9,9,117,113,112,99,100,101,113],
[10,10,10,10,10,10,10,10,10,10,10,10,10,10,36,61,9,9,9,9,9,9,9,9,9,9,9,9,9,9,9,16,9,9,9,9,9,9,9,9,9,87,112,112,113,112,132,112],
[10,10,10,10,10,10,10,10,10,10,10,10,10,36,61,9,9,9,9,9,9,9,9,9,9,9,116,132,9,9,9,9,9,9,9,9,9,9,9,9,9,109,112,115,115,112,112,115],
[10,10,10,10,10,10,10,10,10,10,10,10,10,48,9,9,9,9,9,9,9,9,9,87,118,70,87,118,11,9,9,9,9,9,9,9,9,9,9,9,9,131,108,132,117,112,115,112],
[10,10,10,10,10,10,10,10,10,10,10,10,36,61,9,9,9,9,9,119,70,70,87,116,112,114,117,114,110,9,15,9,9,131,11,9,9,9,9,9,9,9,9,9,120,117,112,112],
[10,10,10,10,10,10,10,10,10,10,10,10,48,9,9,9,15,9,9,131,113,112,113,114,108,110,9,9,9,9,9,9,9,9,117,113,116,9,9,9,9,9,9,9,9,109,112,132],
[10,10,10,10,10,10,10,10,10,10,10,10,48,9,9,9,9,9,9,9,117,108,115,110,9,9,9,9,9,9,9,9,9,9,9,9,133,9,9,9,9,9,9,9,9,109,115,112],
[10,10,10,10,10,10,10,10,10,10,10,36,61,9,9,116,132,9,9,9,9,9,9,9,9,9,9,9,9,9,9,9,9,9,9,9,9,9,9,9,9,9,9,9,9,87,115,112],
[63,63,63,63,63,63,63,33,10,10,10,48,9,9,9,87,118,9,9,9,9,9,9,9,9,15,9,9,9,16,9,9,9,9,9,9,9,9,9,9,9,9,9,9,9,117,115,113],
[9,9,116,117,112,113,118,62,63,33,10,48,9,9,109,112,114,110,9,9,9,9,9,15,13,9,9,9,15,9,9,16,9,9,9,9,9,9,9,15,9,9,9,9,9,109,112,112],
[9,9,9,133,117,112,115,112,11,62,89,61,9,9,87,113,114,9,9,9,9,16,9,59,18,18,18,18,18,18,60,15,9,9,9,9,9,9,9,9,9,9,9,119,112,87,112,115],
[9,9,9,9,120,108,117,112,114,131,88,9,16,9,116,131,9,9,9,15,9,59,18,34,10,36,63,63,33,10,35,18,60,15,16,9,16,126,103,9,9,9,116,87,112,112,112,113],
[9,9,9,9,9,9,131,113,9,19,20,9,9,9,9,9,9,9,16,9,59,34,36,63,63,61,116,11,62,63,63,33,35,18,60,9,9,106,107,9,9,9,120,117,112,113,115,112],
[9,9,9,9,9,9,9,9,9,22,23,24,9,9,9,9,9,9,15,59,34,36,61,119,112,112,115,112,115,112,11,62,63,33,35,60,9,9,15,9,9,9,9,117,113,108,108,117],
[9,9,9,9,9,9,9,9,9,28,29,9,9,9,9,9,9,9,9,58,36,61,113,114,108,117,114,108,108,108,117,113,112,62,33,48,9,9,9,9,9,9,9,120,114,9,9,117],
[9,9,9,9,9,9,9,9,9,133,78,56,57,55,9,59,60,9,9,62,61,119,114,110,9,9,9,9,9,9,120,117,112,11,58,35,60,9,9,9,9,9,9,9,9,9,9,132],
[9,9,9,9,9,9,9,9,132,121,122,132,131,12,9,58,35,60,9,9,116,114,9,9,9,9,9,9,9,9,9,9,117,118,62,33,48,9,9,9,9,9,9,9,9,9,9,117],
[9,9,9,9,9,9,9,113,112,41,42,59,18,46,47,34,10,48,9,9,9,9,9,9,9,9,9,9,9,9,9,9,9,132,133,58,35,60,9,9,9,9,9,9,9,9,9,109],
[9,9,9,9,9,9,9,120,118,11,59,34,10,10,10,10,36,61,132,9,9,9,9,9,9,9,9,9,9,9,9,9,9,9,9,62,63,61,9,9,9,9,9,9,9,9,9,87],
[9,9,9,9,9,9,9,9,132,110,58,10,10,10,36,63,61,114,131,9,9,9,9,9,9,9,9,9,9,9,9,9,9,9,9,9,9,9,9,9,9,9,9,9,9,9,116,112],
[9,9,9,9,9,9,9,9,9,59,34,36,63,63,61,112,115,111,9,9,9,9,9,9,9,9,9,9,9,9,9,9,9,9,9,9,9,9,9,9,9,9,9,9,9,9,109,113],
[9,9,9,112,11,9,9,9,59,34,36,61,112,113,114,108,108,110,9,9,9,9,9,9,9,9,9,9,9,9,9,9,9,9,9,9,9,9,9,133,9,9,9,9,9,9,131,112],
[9,9,9,131,118,70,118,11,58,36,61,113,112,114,131,9,9,9,9,9,9,9,9,9,9,9,9,9,9,9,9,9,9,9,9,9,9,59,60,112,116,9,9,9,9,9,9,117],
[9,9,9,9,120,112,113,111,58,48,112,114,108,110,9,9,9,9,9,9,9,9,9,9,9,9,9,9,9,9,9,9,9,9,9,9,9,58,35,60,118,9,9,9,9,9,9,109],
[9,9,9,9,9,132,117,118,58,48,114,133,9,9,9,9,9,9,9,9,9,9,9,9,9,9,9,9,9,9,9,9,9,9,9,9,9,62,33,48,112,132,9,9,9,9,9,109],
[9,9,9,9,9,9,120,114,58,48,111,9,9,9,9,9,9,9,9,9,9,9,9,9,9,9,9,9,9,9,9,9,9,9,9,9,9,9,58,48,113,118,11,9,9,9,9,87],
[11,9,9,9,9,9,9,133,62,61,132,9,9,9,9,9,9,9,9,9,9,9,9,9,9,9,9,9,9,9,9,9,9,9,9,9,9,9,58,48,114,108,131,21,9,131,132,112],
[133,9,9,9,9,9,9,9,9,9,9,9,9,9,9,9,9,9,9,9,9,9,9,9,9,9,9,9,9,9,9,9,9,9,9,9,9,9,58,74,75,57,25,26,27,55,117,108],
[112,9,9,9,9,9,9,9,9,9,9,9,9,9,9,9,9,9,9,9,9,9,9,9,9,9,9,9,9,9,9,9,9,9,9,9,9,9,58,81,115,114,30,31,32,78,56,57],
[118,11,9,9,9,9,9,9,9,9,9,9,9,9,9,9,9,9,9,9,9,9,9,9,9,9,9,9,9,9,9,9,9,9,9,9,9,9,58,48,114,110,9,9,9,9,9,9],
[112,112,118,115,9,9,9,9,59,60,9,9,9,9,9,9,9,9,9,9,9,9,9,9,9,9,9,9,9,9,9,9,9,9,9,9,9,9,58,48,132,9,9,9,9,9,9,9],
[113,112,113,116,9,9,9,131,58,48,9,9,9,9,9,9,9,9,9,9,9,9,9,9,9,9,9,9,9,9,9,9,9,9,9,9,9,9,58,48,9,9,9,9,9,9,9,9],
[112,115,112,110,9,9,132,123,58,48,9,9,9,9,9,9,9,9,9,9,9,9,9,9,9,9,9,9,9,9,9,9,9,9,9,9,9,9,58,48,9,9,9,9,9,9,9,9],
[115,114,110,9,9,9,43,76,77,35,60,9,9,9,9,9,9,9,9,9,9,9,9,9,9,9,9,9,9,9,9,9,9,9,9,9,9,9,58,48,9,116,116,11,9,9,9,9],
[115,111,9,9,9,43,71,132,82,10,35,60,9,9,9,9,9,9,9,9,9,9,9,9,9,9,9,9,9,9,9,9,9,9,9,9,9,9,58,48,119,87,112,118,133,9,9,9],
[114,131,9,9,9,72,112,111,62,63,33,35,60,9,9,9,9,9,9,9,9,9,9,9,9,9,9,9,9,9,9,9,9,9,9,9,9,59,34,48,132,112,115,112,111,9,9,9],
[111,9,9,9,43,71,115,112,115,11,62,33,35,60,9,9,9,9,9,9,9,9,9,9,9,9,9,9,9,9,9,9,9,9,59,18,18,34,36,61,112,115,112,115,132,9,9,9],
[114,21,9,43,71,9,132,108,117,112,132,62,33,35,18,18,18,18,18,18,18,60,9,9,9,9,9,9,9,9,9,9,9,59,34,36,63,63,61,87,113,112,114,110,9,9,9,9],
[25,26,27,71,9,9,9,9,120,117,112,11,62,63,63,63,63,63,63,63,33,35,18,18,18,18,18,18,18,18,18,18,18,34,36,61,119,112,112,114,108,108,110,9,9,9,9,9],
[30,31,32,9,9,9,9,9,9,9,115,112,115,70,87,118,70,70,70,131,62,63,63,89,63,33,10,10,10,36,63,63,63,63,61,112,87,113,113,111,9,9,9,9,9,9,9,9],
[11,9,9,9,9,9,9,9,9,9,120,117,114,108,133,108,117,114,112,114,108,116,133,88,9,62,63,63,63,61,114,108,108,117,115,112,133,112,114,9,9,9,9,9,9,9,9,119],
[131,9,9,9,9,9,9,9,9,9,9,131,132,9,9,9,9,9,117,132,9,9,19,20,9,9,9,9,9,132,110,9,9,120,108,108,115,113,9,9,9,9,9,9,9,9,9,87],
[112,118,9,9,9,9,9,9,9,9,9,9,9,9,9,9,9,9,9,9,9,9,22,23,24,9,9,9,9,9,9,9,9,9,9,9,112,110,9,9,9,9,9,9,9,9,131,116],
[113,112,132,118,9,9,9,9,9,9,9,9,9,9,9,9,9,9,9,9,9,9,28,29,9,9,9,9,9,9,9,9,9,9,9,9,9,9,9,9,9,9,9,9,9,9,87,113],
[116,113,115,112,11,9,9,9,9,9,9,9,9,9,9,9,9,9,9,9,9,9,43,71,9,9,9,9,9,9,9,9,9,9,9,9,9,9,9,9,9,9,9,9,119,115,116,133]]