[[9,9,9,9,9,9,9,9,9,9,9,9,9,9,9,9,9,9,9,9,132,112,113,116,112,132,112,115,112,112,132,112,133,112,111,58,10,10,10,10,10,10,10,10,10,10,10,10],
[9,9,9,9,9,9,9,9,9,9,9,9,9,9,9,9,9,9,9,9,120,117,112,114,108,108,108,117,115,112,112,115,112,112,111,58,10,10,10,10,10,10,10,10,10,10,10,10],
[9,9,9,9,9,9,9,9,9,9,9,9,9,9,9,9,9,9,9,9,9,131,116,110,9,9,9,109,112,113,131,112,113,112,111,58,10,10,10,10,10,10,10,10,10,10,10,10],
[9,9,9,9,9,9,9,9,9,9,9,9,9,9,9,9,9,9,9,9,9,9,9,9,9,9,9,132,115,112,112,115,116,113,118,62,33,10,10,10,10,10,10,10,10,10,10,10],
[9,9,9,9,9,9,9,9,9,9,9,9,9,9,9,9,9,9,9,9,9,9,9,9,9,9,9,120,117,113,113,112,112,112,131,11,58,10,10,10,10,10,36,63,63,63,33,10],
[9,9,9,9,9,9,9,9,9,9,9,9,9,9,9,9,9,9,9,9,9,9,9,9,9,9,9,9,120,117,114,108,117,113,112,111,58,10,10,10,10,10,48,132,131,133,58,10],
[9,9,9,9,9,9,9,9,9,9,9,9,9,9,9,9,9,9,9,9,9,9,9,9,9,9,9,9,9,9,9,9,109,112,116,111,58,10,10,10,10,36,61,129,37,38,58,10],
[9,9,9,9,9,9,9,9,9,9,9,9,9,9,9,9,9,9,9,9,9,9,9,9,9,9,9,9,9,9,9,9,132,113,112,118,58,10,10,10,10,48,133,49,50,51,58,10],
[9,9,9,9,9,9,9,9,9,9,9,9,9,9,9,9,9,9,9,9,9,9,9,9,9,9,9,9,9,9,9,9,120,112,113,114,58,10,10,10,10,48,131,64,65,66,58,10],
[9,9,9,9,9,9,9,9,9,9,9,9,9,9,9,9,9,9,9,9,9,9,9,9,9,9,9,9,9,9,9,9,9,131,115,132,62,33,10,10,10,48,120,108,59,18,34,10],
[9,9,9,9,9,9,9,9,9,9,9,9,9,9,9,9,9,9,9,9,9,9,9,9,9,9,9,9,9,9,9,9,9,9,9,14,9,58,10,10,10,35,18,18,34,10,10,10],
[9,9,9,9,9,9,9,9,9,9,9,9,9,9,9,9,9,9,9,9,9,9,9,9,9,9,9,9,9,9,9,9,9,9,9,9,9,62,33,10,10,10,10,10,10,10,10,10],
[9,9,9,9,9,9,9,9,9,9,9,9,9,9,9,9,9,9,9,9,9,9,9,9,9,9,9,9,9,9,9,9,9,9,9,9,9,9,58,10,10,10,10,10,10,10,10,10],
[9,9,9,9,9,9,9,9,9,9,9,9,9,9,9,9,9,9,9,9,9,9,9,9,9,9,9,9,9,9,9,9,9,9,9,9,43,76,77,10,10,10,10,10,10,10,10,10],
[9,9,9,9,9,9,9,9,9,9,9,9,9,9,9,9,9,9,9,9,9,9,9,9,9,9,9,9,9,9,9,9,9,9,9,43,71,9,82,10,10,10,10,10,10,10,10,10],
[9,9,9,9,9,9,9,9,9,9,9,9,9,9,9,9,9,9,9,9,9,9,9,9,9,9,9,9,9,9,9,9,43,79,80,71,112,9,62,63,63,63,33,10,10,10,10,10],
[60,9,9,9,9,9,9,9,9,9,9,9,9,9,9,9,9,9,9,9,9,9,9,16,9,9,9,9,9,9,9,43,71,9,119,116,131,9,9,9,9,9,58,10,10,10,10,10],
[35,18,60,9,9,9,9,9,9,9,9,9,9,9,9,9,9,9,9,9,43,79,80,79,55,9,9,9,9,43,79,71,116,9,133,112,9,9,9,9,9,9,58,10,10,10,10,10],
[10,10,35,60,9,9,9,9,9,9,9,9,9,9,9,9,9,9,9,43,71,119,112,11,78,80,80,79,79,71,113,112,133,9,9,9,9,9,9,9,9,9,62,63,33,10,10,10],
[10,10,10,48,9,9,9,9,9,9,9,9,9,9,9,9,9,9,9,72,133,115,113,116,70,112,115,70,70,112,112,131,9,9,9,9,9,9,9,9,9,9,9,9,62,63,63,63],
[10,10,36,61,9,9,9,9,16,9,9,43,56,57,55,9,9,9,9,78,55,131,108,112,132,108,108,113,116,115,111,9,9,9,9,9,9,9,9,9,9,9,9,9,9,9,9,9],
[10,10,48,9,9,15,9,9,9,9,43,71,116,113,78,55,9,9,9,9,78,56,56,56,57,57,57,55,120,131,132,131,9,9,9,9,9,9,9,9,9,9,9,9,131,113,133,9],
[10,10,74,75,80,79,55,9,9,43,71,70,113,112,133,44,9,9,9,9,9,9,9,9,9,9,9,78,56,55,133,9,9,9,9,9,9,9,9,9,9,9,9,133,125,102,131,9],
[10,10,81,14,9,9,78,79,80,71,119,115,116,131,43,71,9,9,9,9,9,9,9,9,9,9,9,9,9,73,9,9,9,9,9,15,9,9,132,9,9,9,9,9,104,105,9,9],
[10,10,48,9,9,9,9,9,119,112,112,108,112,115,45,9,9,9,9,9,9,9,9,9,9,9,9,9,9,72,9,9,9,9,9,9,9,9,9,9,9,9,9,9,9,9,9,9],
[10,10,48,9,9,9,9,9,133,132,111,9,120,132,78,55,9,9,9,9,9,9,9,9,9,9,9,9,9,73,112,11,9,9,116,112,70,133,9,9,9,9,9,9,9,9,9,9],
[10,10,35,60,9,9,9,9,9,120,131,9,9,133,131,45,9,9,9,9,9,9,9,9,9,9,9,9,43,71,112,113,70,70,112,112,113,111,9,9,9,9,9,9,9,119,132,70],
[10,10,10,48,119,131,9,9,9,9,9,9,9,9,9,78,55,9,9,9,9,9,9,9,9,43,79,79,71,112,116,115,113,112,113,116,115,112,132,9,9,9,9,133,70,112,112,112],
[10,10,10,48,132,112,111,9,9,9,9,9,9,9,9,9,78,55,9,21,9,9,9,21,9,73,9,133,112,112,131,9,133,112,115,112,113,131,112,9,9,9,9,113,112,113,112,113],
[10,10,10,48,109,116,111,9,9,133,9,9,9,9,9,9,9,78,25,26,27,79,25,26,27,71,9,9,132,112,9,9,9,132,112,116,112,9,9,9,9,119,112,131,112,112,115,116],
[10,10,10,48,109,115,118,70,70,118,70,70,116,9,9,9,9,9,9,31,9,9,9,31,9,9,9,9,9,9,9,9,9,9,120,131,9,9,9,9,9,133,112,116,113,113,112,112],
[10,10,10,48,120,117,116,112,116,112,121,122,111,9,9,9,9,9,9,9,9,9,9,9,9,9,9,9,9,9,9,9,9,9,9,9,9,9,9,9,9,9,120,115,112,112,112,112],
[10,10,10,35,18,60,117,132,112,115,41,42,111,9,9,9,15,16,9,17,9,9,9,9,9,9,9,9,9,15,9,15,9,9,9,9,9,9,9,9,9,9,9,131,112,112,115,112],
[10,10,10,10,10,35,60,109,113,112,112,116,111,9,9,9,9,9,9,9,15,9,9,15,9,9,15,9,9,9,16,9,9,9,9,9,9,9,9,9,9,9,9,9,133,116,112,112],
[10,10,10,10,10,10,48,109,112,112,113,112,116,9,9,9,9,9,9,9,9,9,9,9,16,9,16,9,14,9,9,9,9,15,9,9,9,9,9,9,9,9,9,9,9,132,113,112],
[10,10,10,10,10,36,61,109,112,113,116,112,111,9,9,9,132,112,112,131,9,9,9,9,9,9,9,9,9,9,9,9,9,9,9,9,9,9,9,9,116,132,9,9,9,112,112,115],
[10,10,10,10,10,48,109,112,115,112,112,133,9,9,9,133,112,112,115,112,11,9,9,9,9,9,9,9,9,9,9,9,9,9,9,9,9,9,70,70,112,112,9,9,9,120,131,112],
[10,10,10,36,63,61,132,117,116,115,111,9,9,9,9,109,115,112,113,112,116,70,116,9,9,119,133,70,132,9,9,9,9,9,9,9,9,9,131,112,115,112,70,9,9,9,112,112],
[10,10,36,61,9,9,9,133,108,108,131,9,9,9,9,109,112,113,112,112,112,113,112,115,113,115,112,112,118,11,9,9,9,87,11,9,112,132,112,116,113,112,133,9,9,9,9,9],
[36,63,61,9,9,9,9,9,9,9,9,9,9,9,9,112,116,112,115,112,108,112,113,127,83,84,112,113,115,111,9,9,9,132,112,131,112,112,115,112,112,132,9,9,9,13,9,9],
[48,133,70,70,132,11,9,9,9,9,9,9,9,9,9,133,112,114,112,133,9,108,112,90,91,92,116,112,113,111,9,9,9,120,131,112,112,112,113,112,112,111,9,9,9,9,9,9],
[61,112,112,108,112,118,70,11,9,9,9,9,9,9,9,9,116,133,9,9,9,9,132,96,97,98,112,112,116,133,9,9,9,9,9,112,115,113,116,112,112,131,9,9,9,9,9,9],
[112,113,116,9,133,108,108,118,131,9,9,9,9,9,9,9,9,9,9,9,9,9,9,133,112,116,112,133,131,9,9,9,9,9,9,133,108,108,112,113,115,9,9,9,9,9,9,9],
[115,111,9,9,9,9,9,133,116,9,9,9,9,131,9,9,9,9,9,9,9,9,9,9,113,112,115,132,9,9,9,9,9,9,9,9,9,9,120,112,111,9,9,9,9,9,9,9],
[113,111,9,9,9,9,9,9,9,9,9,9,112,113,133,9,9,9,9,9,9,9,9,9,112,114,131,9,9,9,9,9,9,9,9,9,9,9,9,132,110,9,9,9,9,9,9,9],
[112,132,9,9,9,9,9,9,9,9,9,9,132,9,9,9,15,9,9,9,9,9,9,9,116,132,9,9,9,9,9,9,9,9,9,9,9,9,9,9,9,9,9,9,9,9,9,9],
[110,9,9,9,9,9,9,9,9,9,9,9,9,9,9,9,9,9,9,9,9,9,9,9,9,9,9,9,9,9,9,9,9,9,9,9,9,9,9,9,9,9,9,9,9,9,9,9],
[9,9,9,9,9,9,9,9,9,9,9,9,9,9,9,9,9,9,9,9,9,9,9,9,9,9,9,9,9,9,9,9,9,9,9,9,9,9,9,9,9,9,9,9,9,9,9,9]]