[[117,116,114,113,112,118,115,113,113,116,115,116,118,113,112,115,116,118,113,115,117,113,112,115,116,113,87,115,112,117,116,113,112,116,115,116,113,118,115,116,112,113,118,115,116,117,116,115],
[112,113,112,117,116,113,112,116,115,116,116,115,116,112,118,116,113,115,110,9,109,117,116,87,112,112,113,108,112,108,112,87,113,113,113,112,118,116,116,114,116,112,116,116,118,117,112,118],
[113,115,116,115,112,116,115,118,116,112,118,116,113,115,116,110,9,9,9,9,109,112,113,112,114,110,9,9,9,9,109,113,114,116,116,115,116,115,113,118,87,115,118,112,113,113,115,112],
[114,118,113,112,116,113,116,112,113,116,116,115,116,110,9,9,9,9,133,9,120,115,112,116,110,9,9,133,9,9,115,117,116,115,114,116,114,117,116,115,116,112,108,115,116,112,115,114],
[112,115,114,110,120,116,113,118,116,118,113,116,110,9,9,9,9,9,9,9,119,113,110,9,9,9,9,9,9,9,120,112,116,113,116,115,9,120,113,110,9,9,9,113,9,120,113,118],
[117,112,9,9,9,9,9,120,113,115,117,115,9,9,9,132,9,9,9,132,112,133,9,9,9,9,9,9,9,9,9,116,114,112,132,9,9,9,9,9,9,9,9,9,9,9,117,116],
[116,110,9,9,9,9,9,9,120,116,87,116,113,131,9,9,133,9,9,9,9,9,9,9,9,9,9,9,9,9,9,9,115,133,9,9,132,9,9,16,9,9,9,9,9,119,115,113],
[115,112,9,9,133,9,9,9,9,115,113,115,116,112,9,9,9,9,9,9,9,9,15,9,9,9,9,9,9,9,9,9,9,9,9,9,9,9,9,9,9,9,9,9,9,109,112,112],
[113,110,9,9,124,132,9,9,9,120,116,116,87,113,9,9,9,16,9,9,9,9,9,9,9,9,9,9,9,9,16,9,9,9,9,133,116,131,9,9,9,9,9,9,9,120,113,115],
[118,11,9,16,9,131,9,9,9,9,9,131,116,112,115,9,9,9,113,115,70,116,9,9,9,9,9,9,9,9,9,9,9,113,112,115,112,116,9,9,9,9,9,9,9,9,116,118],
[112,115,9,9,9,9,9,9,9,9,9,9,9,113,116,11,9,9,116,112,113,112,116,9,9,9,9,9,9,9,9,9,9,9,131,112,113,118,70,112,132,9,9,9,9,9,120,113],
[110,9,9,9,9,9,133,70,112,70,133,9,9,9,112,113,9,9,9,131,116,115,112,113,116,132,9,9,9,9,9,14,9,9,9,9,117,115,113,116,115,9,9,132,9,9,9,112],
[9,9,9,9,70,113,112,115,116,116,113,9,9,9,115,114,115,9,9,9,112,110,9,9,115,112,70,115,113,9,9,9,9,131,9,9,131,112,114,115,110,9,9,9,131,9,9,116],
[9,9,9,116,108,112,113,112,113,115,112,70,133,9,131,116,132,9,9,9,9,9,9,9,9,115,112,113,116,9,131,9,9,9,9,9,9,9,113,132,9,9,9,115,9,9,9,109],
[119,132,9,9,9,9,132,115,116,112,113,116,115,9,9,9,9,9,9,9,9,9,9,9,9,109,113,116,131,9,9,9,9,9,9,9,9,9,9,9,9,9,14,131,132,9,9,120],
[112,113,115,9,9,9,9,9,120,113,117,112,111,9,9,9,9,9,9,9,9,9,9,9,9,131,108,115,9,9,9,9,9,9,115,133,9,9,9,9,9,9,9,9,9,9,9,119],
[126,103,112,116,9,9,14,9,9,9,109,115,113,112,9,9,9,9,9,9,9,9,9,15,9,9,9,9,9,9,9,9,9,9,123,112,116,9,9,133,9,9,9,9,9,9,9,112],
[106,107,115,113,9,9,9,9,9,9,112,116,115,111,9,9,9,9,9,9,9,9,9,9,132,9,9,9,16,9,9,9,9,9,115,113,131,9,9,9,9,9,9,9,9,9,116,116],
[115,113,116,132,9,9,9,9,9,9,109,113,112,116,9,9,9,9,9,9,9,131,9,9,9,9,9,9,9,9,9,124,9,9,132,9,9,9,9,9,9,9,9,9,113,116,113,87],
[114,132,9,9,9,9,9,9,9,109,87,112,113,111,9,9,131,9,9,9,133,132,9,9,9,9,9,9,9,9,15,131,13,9,9,9,9,9,9,9,9,112,116,113,116,114,116,114],
[110,9,9,9,9,9,9,9,9,112,113,115,116,133,9,133,15,9,9,131,123,131,9,13,9,9,9,9,9,9,9,9,9,9,9,9,9,9,9,9,9,116,114,116,112,116,111,116],
[9,9,131,9,9,9,9,9,9,9,131,112,133,9,9,9,9,9,133,132,9,132,9,9,9,9,9,9,9,9,9,9,9,9,9,9,9,9,9,9,9,9,116,115,116,87,116,111],
[9,9,9,9,9,9,9,9,9,9,9,9,9,9,9,9,9,9,9,9,9,9,9,9,9,9,9,9,9,9,9,9,9,9,9,9,9,9,9,9,9,9,9,116,111,115,116,115],
[70,70,132,9,9,9,9,9,9,133,9,9,9,9,9,9,9,9,9,9,9,9,9,9,9,9,9,9,9,9,9,9,9,9,9,9,9,9,9,9,9,9,9,115,113,113,114,116],
[87,112,133,9,9,9,9,9,9,9,9,9,9,9,9,9,9,9,9,9,9,9,9,9,9,9,9,9,9,9,9,9,9,9,9,9,9,9,9,9,9,9,9,9,112,116,116,116],
[113,116,9,9,9,133,116,132,9,9,9,9,9,9,9,9,9,9,9,9,9,9,9,9,9,9,9,9,9,9,9,9,9,9,9,9,9,9,9,9,9,9,9,9,115,111,116,87],
[110,9,9,9,109,115,112,118,70,131,9,9,9,9,9,9,9,9,9,9,9,9,9,9,9,9,9,9,9,9,9,9,9,9,9,9,9,9,9,9,9,9,9,9,116,116,112,113],
[9,9,9,133,116,112,113,115,114,133,9,9,9,9,9,9,9,9,9,9,9,9,9,9,9,9,9,9,9,9,9,9,9,9,9,9,9,9,9,9,9,9,9,113,115,114,116,116],
[9,131,9,9,9,109,116,114,132,9,9,9,9,9,9,9,9,9,9,9,9,9,9,9,9,9,9,9,9,9,9,9,9,9,9,9,9,9,9,9,9,9,9,112,116,115,116,114],
[9,9,9,9,9,132,112,131,9,9,9,9,9,9,9,9,9,9,9,9,9,9,9,9,9,9,9,9,9,9,9,9,9,9,9,9,9,9,9,9,9,9,9,9,9,9,115,113],
[9,9,9,9,9,9,15,9,9,9,9,9,9,9,9,9,123,9,9,131,133,9,9,9,9,9,9,9,9,9,9,9,9,9,9,9,9,9,9,9,9,9,9,9,9,9,116,116],
[9,9,9,9,9,9,9,9,9,9,9,9,9,9,9,9,133,9,9,133,132,9,9,9,9,9,9,9,9,9,9,9,9,9,9,9,9,9,9,9,9,9,9,9,9,9,112,111],
[9,9,9,9,9,9,9,9,9,9,9,9,9,9,9,9,9,9,132,9,9,9,9,9,9,9,9,9,9,9,9,9,9,9,116,112,9,9,9,9,9,9,9,9,9,9,116,115],
[9,9,9,9,9,9,9,13,9,9,9,9,9,9,9,9,9,9,133,9,9,132,9,9,9,9,9,9,9,9,9,9,9,116,113,116,9,9,9,9,9,9,9,9,9,9,113,112],
[9,9,9,9,9,9,132,131,9,9,9,9,9,9,9,9,9,9,9,9,9,9,9,9,9,9,9,9,9,9,9,9,9,112,124,115,116,133,9,9,9,9,9,9,9,9,116,116],
[11,9,9,9,9,132,133,9,9,9,9,9,9,9,9,132,9,9,9,112,115,112,113,9,9,9,9,9,9,9,9,132,9,113,116,113,9,9,9,9,9,9,9,112,116,113,115,87],
[118,131,9,9,9,9,9,9,9,9,9,9,9,9,9,124,9,9,9,113,123,121,116,9,9,9,9,9,9,9,9,131,9,9,9,112,9,9,9,9,9,9,9,9,9,9,116,113],
[116,111,9,9,133,9,9,9,9,9,9,9,9,9,9,133,9,9,9,115,122,116,131,9,9,9,9,9,9,9,9,133,9,9,9,13,133,14,9,9,9,9,9,9,9,9,112,116],
[115,118,131,9,9,9,9,9,9,9,9,9,9,9,9,131,9,9,9,116,115,112,116,132,9,9,9,9,131,133,9,9,9,9,9,9,9,9,9,9,9,9,9,9,9,9,116,111],
[112,114,110,9,9,9,132,9,9,9,9,9,9,9,9,133,9,9,9,9,9,133,9,9,132,9,9,9,133,132,9,9,9,132,131,133,9,9,9,9,132,9,9,112,113,116,115,114],
[113,111,9,9,9,9,9,9,9,9,9,9,9,9,9,9,133,132,9,9,9,131,9,9,133,9,9,9,131,9,9,133,9,132,121,122,9,9,9,9,133,9,9,116,112,87,116,113],
[114,132,9,9,9,9,9,9,9,9,9,9,9,9,9,132,131,133,9,133,132,133,9,9,9,9,9,9,133,9,9,131,9,9,41,42,9,9,9,9,59,18,18,18,18,18,60,116],
[110,9,9,9,9,9,9,14,9,9,9,9,9,9,9,133,9,9,9,9,9,9,9,132,9,9,133,9,9,9,9,9,131,9,131,9,9,9,9,9,58,10,10,10,10,10,35,18],
[133,9,9,9,9,9,9,9,9,9,9,9,9,9,9,131,9,9,9,9,9,9,9,133,9,9,116,115,113,116,116,9,9,9,9,9,123,113,112,116,58,10,10,10,10,10,10,10],
[11,9,9,9,9,9,9,9,9,9,9,9,9,9,9,9,9,9,9,9,9,9,9,116,116,115,116,115,116,115,114,116,116,116,87,116,116,59,18,18,34,10,10,10,10,10,10,10],
[118,11,9,9,9,9,116,9,9,9,9,9,9,9,9,9,9,116,113,116,115,116,112,116,115,87,115,116,114,113,116,115,112,59,18,18,18,34,10,10,10,10,10,10,10,10,10,10],
[113,112,115,70,116,113,116,11,9,9,9,9,9,9,9,113,116,112,116,115,116,87,116,115,116,116,111,115,116,115,116,113,116,58,10,10,10,10,10,10,10,10,10,10,10,10,10,10],
[116,114,116,116,112,115,87,116,108,116,113,114,115,112,116,114,116,116,108,116,115,114,113,116,115,116,113,116,87,116,108,116,59,34,10,10,10,10,10,10,10,10,10,10,10,10,10,10]]