[[10,10,10,10,10,10,10,48,115,112,113,114,131,9,9,9,9,9,9,9,9,9,9,9,9,9,9,9,120,117,112,112,113,116,112,115,112,112,112,115,112,112,113,112,116,116,112,115],
[10,10,10,10,10,10,10,48,114,117,114,9,9,9,9,9,9,9,9,9,9,9,9,9,9,9,9,9,9,132,117,115,112,114,108,108,108,108,132,113,115,112,112,116,112,115,116,112],
[10,10,10,10,10,10,10,48,132,9,9,9,9,9,9,9,9,9,9,9,9,9,9,9,132,9,9,9,9,9,131,108,108,110,9,9,9,9,109,116,131,112,127,83,84,112,132,116],
[10,10,10,10,10,10,10,48,9,9,9,9,9,9,9,9,9,9,9,9,9,9,9,87,111,9,9,9,9,9,9,9,9,9,9,9,9,9,87,112,116,113,90,91,92,112,116,115],
[10,10,10,10,10,10,10,48,131,9,9,9,9,9,9,9,9,9,9,9,9,9,87,113,111,9,9,9,9,9,9,9,9,9,9,9,9,9,117,115,112,112,96,97,98,112,116,112],
[10,10,10,10,10,10,10,48,132,133,9,9,9,9,9,9,9,9,9,9,119,87,115,112,111,9,9,9,9,9,9,9,9,9,9,9,9,9,131,108,117,114,117,112,115,116,112,113],
[10,10,10,10,10,10,36,61,117,111,9,9,9,9,9,9,9,9,9,87,113,112,116,114,132,9,9,9,9,9,9,9,9,9,9,9,9,9,9,9,9,9,120,132,129,37,38,116],
[10,10,10,10,10,10,48,119,87,118,87,118,11,119,114,132,9,21,9,131,114,117,115,111,9,9,9,9,9,9,9,9,9,9,9,9,9,9,9,9,9,9,9,109,49,50,51,112],
[10,10,10,10,10,10,48,131,108,108,108,108,117,114,43,56,25,26,27,57,55,120,108,133,9,9,9,9,9,9,9,9,9,9,9,9,9,9,9,9,9,9,9,109,64,65,66,112],
[10,10,10,10,10,10,74,75,57,56,56,57,56,57,71,9,30,31,32,9,78,56,57,56,55,9,9,131,133,9,9,9,9,9,9,9,9,9,9,9,9,9,9,133,117,116,113,112],
[10,10,10,10,10,10,81,9,9,9,9,9,9,9,9,9,9,9,9,9,9,9,9,9,78,56,57,55,117,11,9,9,9,9,9,9,9,9,9,9,9,9,9,9,109,133,112,116],
[10,10,10,10,10,36,61,9,9,9,9,9,9,9,9,9,9,9,9,9,9,9,9,9,9,9,9,78,55,117,111,9,9,9,114,108,133,116,9,9,9,9,9,119,87,116,116,131],
[10,10,10,10,10,48,9,9,9,9,9,9,9,9,9,9,9,9,9,9,9,9,9,9,9,118,9,9,78,55,132,9,21,9,43,56,55,132,9,9,9,9,9,109,112,133,113,112],
[10,10,10,10,10,48,9,9,9,9,9,9,9,9,9,9,9,9,9,9,9,9,9,9,9,112,133,9,9,78,57,25,26,27,71,9,73,9,9,9,9,9,9,131,117,116,112,116],
[10,10,10,10,36,61,9,9,9,9,9,9,9,9,9,9,9,9,9,9,9,9,9,9,9,113,111,9,9,9,9,30,31,32,9,9,78,55,9,9,9,9,9,9,109,116,133,112],
[10,10,10,36,61,9,9,9,9,9,9,9,9,9,9,9,9,9,9,9,9,9,9,9,9,115,111,9,9,9,9,9,9,9,9,9,9,73,131,118,9,9,9,9,117,112,116,113],
[10,10,10,48,9,9,9,9,9,9,9,9,9,9,9,9,9,9,9,9,9,9,9,9,9,116,111,9,9,9,9,9,9,9,9,9,9,78,55,120,114,9,9,9,9,131,117,112],
[10,10,10,48,9,9,9,9,9,9,9,9,9,9,9,9,9,9,9,9,9,9,9,9,9,112,133,9,9,9,15,9,9,9,9,9,9,9,78,55,133,9,9,9,9,9,109,116],
[10,10,10,48,9,9,9,9,9,9,9,9,9,9,9,9,9,9,9,9,9,9,9,9,9,9,9,9,16,9,9,9,9,9,9,9,9,9,9,73,9,9,9,9,9,9,87,115],
[10,10,10,48,9,9,9,9,9,9,9,9,9,9,9,9,9,9,9,9,9,9,9,9,9,9,9,9,9,9,9,9,9,9,9,9,9,9,19,20,9,9,9,9,9,9,117,113],
[10,10,10,48,9,9,9,9,9,9,9,9,9,9,9,9,9,9,9,9,9,9,9,9,9,9,9,9,9,9,15,9,9,9,9,9,9,9,22,23,24,9,9,9,9,9,109,116],
[10,10,10,48,9,9,9,9,9,9,9,9,9,9,9,9,9,9,9,9,9,9,9,9,9,9,9,9,9,9,9,9,9,9,9,9,9,9,28,72,131,9,9,9,9,119,87,112],
[10,10,10,48,9,9,9,9,9,9,9,9,9,9,9,9,9,9,9,9,9,9,9,9,9,9,9,9,9,9,87,131,70,132,11,9,9,9,9,12,118,132,9,9,9,109,112,116],
[10,10,10,48,9,9,9,9,9,9,9,9,9,9,9,9,9,9,9,9,9,9,9,9,9,9,9,9,9,87,112,113,112,115,118,131,9,59,18,46,47,60,9,9,9,109,116,113],
[10,10,10,48,9,9,9,9,9,9,9,9,9,9,9,9,9,9,9,9,9,9,9,9,9,113,118,9,9,114,108,108,108,108,108,116,59,34,10,10,10,35,60,9,9,109,113,112],
[10,10,10,48,9,9,9,9,9,9,9,9,9,9,9,9,9,9,9,9,9,9,9,9,9,115,111,9,9,132,59,18,18,18,18,18,34,10,10,10,10,10,48,131,9,9,116,115],
[10,10,36,61,9,9,9,9,9,9,9,9,9,9,9,9,9,9,9,9,9,9,9,9,9,112,114,9,9,59,34,10,10,10,10,10,10,10,10,10,10,10,48,111,9,116,117,112],
[10,10,48,9,9,9,9,9,9,9,9,9,9,9,9,9,9,9,9,9,9,9,9,9,9,114,9,9,59,34,10,10,10,10,10,10,10,10,10,10,10,10,48,111,9,9,9,113],
[10,10,48,9,9,9,9,9,9,9,9,9,9,9,9,9,9,9,9,9,9,9,9,9,9,111,9,9,58,10,10,10,10,10,10,10,10,10,10,10,10,10,48,118,132,9,9,115],
[10,10,48,9,9,9,9,9,9,9,9,9,9,9,9,9,9,9,9,9,9,9,9,9,9,111,9,9,58,10,10,10,10,10,10,10,10,10,10,10,10,10,35,60,111,9,9,117],
[10,10,48,9,9,9,9,9,9,9,9,9,9,9,9,9,9,9,9,9,9,9,9,9,9,116,9,9,58,10,10,10,10,10,10,10,10,10,10,10,10,10,10,48,133,9,9,87],
[10,10,48,9,9,9,9,9,9,9,9,9,9,9,9,9,9,9,9,9,9,9,9,9,9,9,9,9,58,10,10,10,10,10,10,10,10,10,10,10,10,10,10,48,9,9,87,113],
[10,10,48,9,9,9,9,9,9,9,9,9,9,9,9,9,9,9,9,9,9,9,9,9,9,9,9,59,34,10,10,10,10,10,10,10,10,10,10,10,10,10,10,48,9,9,109,112],
[10,10,35,60,9,9,9,9,9,9,9,9,9,9,9,9,9,9,9,9,9,9,9,9,9,9,9,58,10,10,10,10,10,10,10,10,10,10,10,10,10,10,10,48,9,9,109,115],
[10,10,10,35,60,9,9,9,9,9,9,9,9,9,9,9,9,9,9,9,9,9,9,9,9,9,9,58,10,10,10,10,10,10,10,10,10,10,10,10,10,10,10,48,9,9,117,112],
[10,10,10,10,35,60,9,9,9,9,9,9,9,9,9,9,9,9,9,9,112,116,112,116,9,9,9,62,33,10,10,10,10,10,10,10,10,10,10,10,10,10,10,48,131,9,9,117],
[10,10,10,10,10,35,60,9,9,9,9,9,9,9,9,9,9,9,9,9,115,113,114,131,9,9,9,9,58,10,10,10,10,10,10,10,10,10,10,10,10,10,10,48,111,9,9,109],
[10,10,10,10,10,10,48,9,9,9,9,9,9,9,9,9,9,9,9,9,112,110,9,9,9,9,9,9,62,63,63,33,10,10,10,10,10,10,10,10,10,10,10,48,111,9,9,109],
[10,10,10,10,10,10,48,9,9,9,9,9,9,9,9,9,9,113,117,113,114,9,9,9,9,9,9,9,9,9,9,58,10,10,10,10,10,10,10,10,10,10,36,61,133,9,9,109],
[10,10,10,10,10,10,35,60,9,9,9,9,9,9,9,9,9,9,133,114,9,9,9,9,9,9,9,9,9,9,9,58,10,10,10,10,10,10,10,10,10,36,61,132,110,9,9,109],
[10,10,10,10,10,10,10,48,9,9,9,9,9,9,9,9,9,9,9,9,9,9,9,9,9,9,9,9,9,43,76,77,10,10,10,10,36,63,63,89,63,61,113,110,9,9,131,87],
[10,10,10,10,10,10,10,48,9,9,9,9,9,9,9,9,9,9,9,9,9,9,9,9,9,9,9,9,9,72,131,82,10,10,10,10,48,112,118,88,112,113,114,9,9,9,87,115],
[10,10,10,10,10,10,10,48,9,9,9,9,9,9,9,9,21,9,9,9,9,9,21,9,9,9,43,56,57,71,132,62,63,63,63,63,61,108,110,72,133,114,9,9,9,87,112,112],
[10,10,10,10,10,10,10,48,9,9,9,9,9,43,56,25,26,27,56,57,57,25,26,27,57,56,71,113,112,115,116,112,113,110,9,9,9,9,19,20,9,9,9,9,119,132,115,112],
[10,10,10,10,10,10,10,48,9,9,43,56,57,71,9,30,31,32,113,112,132,30,31,32,9,9,9,120,108,117,115,114,133,9,9,9,9,9,22,23,24,9,9,9,87,112,113,116],
[10,10,10,10,10,10,10,35,60,9,12,9,9,9,9,9,9,9,117,114,9,9,9,9,9,9,9,9,9,132,116,9,9,9,9,9,9,9,28,29,9,9,9,109,112,113,112,112],
[10,10,10,10,10,10,10,10,35,18,46,47,60,9,9,9,9,9,9,9,9,9,9,9,9,9,9,9,9,9,9,9,9,9,9,9,9,9,116,78,55,9,119,87,113,112,132,116],
[10,10,10,10,10,10,10,10,10,10,10,10,48,9,9,9,9,9,9,9,9,9,9,9,9,9,9,9,9,9,9,9,9,9,9,9,9,87,116,131,72,133,112,112,112,112,116,112]]