[[10,9,13,9,9,12,9,9,14,9,9,11,9,15,9,13,9,9,9,11,9,9,10,9,56,42,42,42,42,42,42,42,42,42,42,42,42,42,42,42,42,42,42,42,42,42,42,42],
[9,12,9,11,9,9,10,9,9,20,9,9,16,9,9,9,10,9,9,9,15,9,9,9,56,42,42,42,42,42,42,42,42,42,42,42,42,42,42,42,42,42,42,42,42,42,42,42],
[11,9,10,16,13,9,9,9,11,115,26,15,9,10,9,9,9,9,14,9,9,16,9,13,54,42,42,42,42,42,42,42,42,42,42,42,42,42,42,42,42,42,42,27,91,91,91,34],
[14,13,9,9,9,11,9,14,13,10,78,26,9,9,9,9,15,9,12,9,9,9,9,9,9,91,10,91,34,42,42,42,42,42,42,42,42,42,42,42,42,42,42,79,12,115,63,56],
[9,9,9,14,9,9,13,28,65,65,65,35,11,12,9,9,9,9,9,11,81,93,10,9,14,9,15,16,54,42,42,42,42,42,42,42,42,42,42,42,42,42,42,79,9,75,76,56],
[10,9,12,9,9,15,9,56,42,42,42,42,79,9,9,15,9,9,9,81,104,100,9,12,9,11,9,117,90,56,42,42,42,42,42,42,42,42,42,42,42,42,46,16,9,10,11,56],
[9,11,9,9,16,9,12,56,42,42,42,42,79,14,9,9,10,9,15,122,10,101,103,92,92,93,10,98,99,56,42,42,42,42,42,42,42,42,42,27,91,23,9,13,15,9,9,56],
[12,9,9,13,9,10,9,56,42,42,42,42,79,15,9,9,9,9,24,25,26,9,11,15,9,100,81,92,103,83,42,42,42,42,42,42,42,42,42,79,9,9,9,9,9,9,12,56],
[9,14,9,9,11,9,11,56,42,42,42,42,33,35,13,9,16,13,9,123,12,9,14,9,13,101,104,75,78,56,42,42,42,42,42,42,42,42,42,79,11,9,11,9,9,11,9,54],
[13,9,16,9,28,65,65,53,42,42,42,42,42,42,35,18,81,103,103,104,9,9,9,9,9,9,9,15,23,54,42,42,42,42,42,42,42,42,42,79,9,9,9,12,9,9,12,10],
[115,26,28,65,53,42,42,42,42,42,42,42,42,42,42,57,104,16,9,15,9,10,9,9,11,9,14,9,11,9,91,10,91,34,42,42,42,42,42,79,9,10,9,9,11,9,9,9],
[10,76,56,42,42,42,42,42,42,42,42,42,42,42,42,115,64,11,9,9,9,9,9,14,9,12,9,9,9,9,15,9,11,54,42,42,42,42,46,10,9,9,14,9,9,10,9,9],
[15,28,53,42,42,42,42,42,42,42,42,42,42,42,42,65,65,35,10,14,9,9,16,9,15,9,9,10,9,12,9,9,9,9,91,46,91,91,91,14,9,9,9,15,9,9,9,11],
[65,53,42,42,42,42,42,42,42,42,42,42,42,42,42,42,42,42,79,9,9,11,9,9,9,9,9,9,9,9,9,14,9,9,12,9,16,9,11,9,12,9,9,9,81,103,103,93],
[42,42,42,42,42,42,42,42,42,42,42,42,42,42,42,42,42,46,79,9,12,9,14,9,9,11,9,9,15,9,9,9,9,11,9,9,10,9,9,9,9,16,9,10,100,19,9,80],
[42,42,42,42,42,42,42,42,42,42,42,42,42,27,91,91,91,9,11,9,9,9,16,9,10,9,9,9,9,12,10,9,9,9,9,9,9,9,16,9,9,9,14,9,80,10,9,100],
[42,42,42,42,42,42,42,42,42,42,42,42,42,33,35,9,10,9,9,14,10,9,9,9,9,9,13,9,9,9,9,11,9,9,9,14,9,9,9,9,12,9,9,11,100,9,81,104],
[42,42,42,42,42,42,42,42,42,42,42,42,42,42,46,9,9,9,15,9,9,11,9,9,9,9,9,9,11,9,16,9,9,13,9,9,10,9,9,13,9,10,81,103,104,9,80,118],
[42,42,42,42,42,42,42,42,42,42,42,42,42,79,11,9,13,9,9,9,9,9,9,10,9,16,9,9,9,9,9,9,9,9,9,14,9,9,9,81,103,103,104,9,12,9,100,109],
[42,42,42,42,42,42,42,42,42,42,42,42,46,16,9,9,9,9,10,9,9,9,9,9,9,9,9,12,9,13,9,10,9,9,11,9,9,9,11,100,11,9,13,9,9,11,101,93],
[42,42,42,42,42,42,42,42,42,42,42,27,11,9,11,9,14,9,9,11,10,9,9,13,9,9,9,9,9,9,9,9,9,16,9,9,9,13,9,80,9,9,11,15,9,9,9,80],
[42,42,42,42,42,42,42,42,42,42,42,120,105,15,9,9,10,9,14,9,9,9,9,15,9,11,9,9,15,9,9,11,9,9,9,10,9,9,9,100,10,13,9,9,9,14,9,80],
[42,42,42,42,42,42,42,42,42,42,42,75,78,16,9,11,9,9,9,9,9,12,9,9,9,9,10,9,9,9,14,9,9,12,9,9,9,15,11,101,93,9,9,11,9,9,12,100],
[42,42,42,42,42,42,42,42,42,42,42,79,15,9,9,9,15,9,15,9,9,15,9,14,9,16,9,9,9,9,9,13,9,9,9,9,9,15,9,14,100,9,12,9,9,9,9,80],
[44,44,34,42,42,42,42,42,42,42,42,33,35,116,64,9,81,103,93,9,13,9,20,9,15,9,16,13,81,102,103,93,9,14,9,15,9,9,9,15,100,9,9,9,9,9,9,100],
[105,111,106,34,42,42,42,42,42,42,42,42,42,77,78,14,100,17,101,103,103,21,22,121,103,103,103,103,104,116,64,101,102,103,103,93,14,10,9,81,104,12,9,9,24,9,9,100],
[106,107,111,107,34,42,42,42,42,42,42,42,42,57,103,103,104,10,14,13,9,9,23,9,9,12,11,9,9,77,78,9,9,16,9,101,103,93,118,80,11,9,9,9,10,15,9,80],
[111,107,43,106,110,105,34,42,42,42,42,42,42,119,26,15,9,13,9,9,11,9,16,9,10,9,9,9,11,9,10,9,9,9,9,9,17,101,103,104,9,9,9,9,9,9,9,80],
[110,58,107,106,23,106,109,110,56,42,42,42,42,33,65,35,9,117,63,9,9,9,9,9,9,16,9,9,9,9,9,9,11,9,9,16,9,10,9,17,120,9,9,9,9,81,103,104],
[108,70,13,11,9,12,16,9,56,42,42,42,42,42,42,42,79,75,78,13,9,12,9,9,9,117,64,9,9,16,9,9,9,9,9,9,9,9,120,118,9,9,12,9,9,80,118,106],
[85,71,44,9,11,9,16,9,54,42,42,42,42,42,42,42,33,65,35,9,9,9,9,12,9,98,78,11,9,9,9,9,10,9,9,9,16,9,9,18,119,118,9,9,13,100,108,111],
[65,65,105,15,9,9,9,9,9,56,42,42,42,42,42,42,42,42,42,65,35,15,9,9,11,9,10,9,9,9,12,9,9,9,9,9,9,9,9,13,9,19,118,9,9,101,93,68],
[42,42,79,60,16,9,9,15,9,56,42,42,42,42,42,42,42,42,42,42,42,26,26,9,9,9,14,9,9,10,9,9,9,9,9,9,9,9,9,9,9,120,9,12,117,90,80,71],
[42,42,33,110,9,9,11,9,9,56,42,42,42,42,42,42,42,42,42,42,42,13,9,14,9,9,9,9,9,9,9,9,9,9,9,9,9,9,9,9,9,9,11,9,98,76,100,108],
[42,42,42,110,11,9,9,16,9,56,42,42,42,42,42,42,42,42,42,42,42,115,90,9,13,9,9,16,9,9,9,9,9,9,9,9,9,9,9,9,9,13,9,15,10,14,80,70],
[42,42,42,97,105,15,9,9,9,56,42,42,42,42,42,42,42,42,42,42,42,98,78,9,9,9,9,9,9,9,9,9,9,9,9,9,9,9,9,9,10,9,9,15,9,9,80,109],
[42,42,42,33,109,9,9,13,17,56,42,42,42,42,42,42,42,42,42,42,46,9,13,9,14,9,9,14,9,9,9,9,9,9,9,9,9,9,9,9,9,9,9,9,9,9,100,107],
[42,42,42,42,79,10,16,28,65,53,42,42,42,42,42,42,42,27,10,12,15,9,9,15,9,9,12,9,10,9,9,9,9,9,9,9,9,9,9,9,9,9,9,9,13,9,80,119],
[42,42,42,46,106,11,28,53,42,42,42,42,42,42,42,42,46,15,14,16,9,9,9,9,9,9,9,9,9,9,9,9,9,9,9,9,9,9,9,9,15,9,9,11,9,9,100,71],
[42,42,42,79,108,9,56,42,42,42,42,42,42,42,42,63,90,9,9,15,9,9,11,9,12,14,9,9,16,9,9,9,9,9,9,9,9,9,9,9,9,9,9,81,103,103,104,106],
[42,42,42,33,35,10,54,42,42,42,42,42,42,42,42,99,76,13,9,9,13,9,9,9,9,9,9,9,9,9,9,9,9,9,9,9,9,9,9,9,9,9,9,101,93,107,111,110],
[42,42,42,42,46,9,15,9,34,42,42,42,42,42,42,10,10,9,11,9,9,9,9,15,9,9,13,9,9,9,9,9,9,9,9,9,9,9,9,9,11,9,13,11,100,109,69,70],
[42,42,42,27,23,119,16,9,56,42,42,42,42,42,42,15,14,13,9,13,9,11,9,14,63,116,9,9,16,9,15,9,9,9,9,9,9,9,9,9,9,9,115,64,80,106,107,71],
[42,42,46,13,110,13,9,118,54,42,42,42,42,42,46,26,10,117,90,9,9,9,9,12,98,78,9,15,9,9,9,9,9,9,9,9,9,9,14,15,9,9,75,78,100,110,96,86],
[9,15,15,15,9,14,10,9,116,64,11,10,16,23,15,16,9,98,99,11,9,15,9,9,13,11,9,9,9,9,12,13,9,9,10,9,9,9,9,9,9,12,9,10,80,111,107,109],
[105,9,13,11,120,118,15,11,77,78,9,14,118,11,9,13,9,9,10,9,11,115,64,9,9,9,16,9,9,14,9,11,9,12,9,9,16,9,13,9,15,9,13,9,100,58,59,60],
[14,15,118,16,15,10,16,13,14,12,13,119,119,120,13,81,92,103,93,15,9,98,76,81,92,93,9,10,9,9,9,9,9,10,9,9,9,9,9,11,9,9,9,81,104,84,85,86],
[13,9,12,118,13,11,119,15,12,10,120,118,10,12,9,100,118,119,101,92,103,92,103,104,119,101,92,103,103,92,103,92,103,103,103,92,103,103,92,92,103,92,103,104,108,108,110,111]]