[[112,116,115,112,112,116,111,9,9,9,9,9,9,9,9,9,9,9,132,116,115,113,110,43,71,112,115,112,115,113,112,112,116,115,115,112,116,113,112,111,45,109,112,112,116,112,112,112],
[112,129,37,38,133,112,111,9,9,119,118,112,9,9,9,9,9,9,9,112,131,114,43,71,112,115,112,113,112,112,116,112,116,112,112,116,112,113,113,118,44,109,112,113,133,112,132,112],
[116,49,50,51,116,114,110,9,9,117,132,113,118,9,9,9,9,9,9,113,110,43,71,112,113,114,117,114,108,117,112,115,115,112,115,115,116,116,113,114,45,109,131,115,112,112,112,115],
[115,64,65,66,112,111,9,9,9,9,112,116,114,123,9,9,9,9,9,117,43,71,114,108,108,110,9,9,9,120,117,115,113,112,115,115,116,112,116,111,44,109,112,112,113,133,113,112],
[112,112,112,112,131,118,9,9,9,9,9,117,110,9,9,9,9,9,133,43,71,114,110,9,9,9,9,9,9,9,87,113,112,112,113,112,113,112,113,111,45,132,112,112,132,112,113,112],
[112,133,132,112,114,131,9,9,9,9,9,9,9,9,9,9,9,43,56,71,114,131,9,9,9,9,9,9,9,9,9,9,120,108,108,117,114,108,132,110,78,55,120,117,112,115,116,114],
[113,112,116,112,111,9,9,9,9,9,9,9,9,9,9,9,43,71,114,131,110,9,9,9,9,9,9,9,9,9,9,9,9,9,9,9,9,9,9,9,9,78,79,55,113,114,131,59],
[112,131,113,133,111,9,9,9,9,9,9,9,9,9,9,19,20,133,132,9,9,9,9,9,9,9,9,9,9,9,9,9,9,9,9,9,9,9,131,9,9,9,9,12,133,59,18,34],
[132,112,115,113,111,9,9,9,9,9,9,9,9,9,9,22,23,24,9,9,9,9,9,9,9,9,9,9,9,9,9,9,9,9,9,9,9,9,9,9,132,9,59,46,47,34,10,10],
[113,112,132,112,111,9,9,9,9,9,9,9,133,11,9,28,29,9,9,9,9,9,9,9,9,9,9,9,9,9,9,9,9,9,9,9,9,9,9,9,133,9,58,10,10,10,10,10],
[131,112,115,112,111,9,9,9,9,9,9,9,112,118,87,131,44,9,9,9,9,9,9,9,9,9,9,9,9,9,9,113,114,9,9,9,9,9,9,9,9,9,58,10,10,10,10,10],
[115,133,116,114,110,9,9,9,9,9,9,16,113,112,113,118,45,9,9,9,9,9,9,9,9,9,9,9,9,9,9,108,132,9,9,9,9,9,9,9,9,59,34,10,10,10,10,10],
[112,112,112,110,9,9,9,9,9,9,9,9,9,120,117,114,44,9,9,9,9,9,9,9,9,9,9,9,9,9,9,9,9,9,116,114,9,9,9,9,9,58,10,10,10,10,10,10],
[112,114,110,9,9,9,9,9,9,9,9,9,9,9,120,110,78,55,9,9,9,9,9,9,9,9,9,9,9,9,9,9,9,9,117,131,9,9,9,9,59,34,10,10,10,10,10,10],
[108,133,9,9,9,9,9,9,9,9,9,9,15,9,9,9,124,45,9,9,9,9,9,9,9,9,9,9,9,9,9,9,9,9,9,9,9,9,9,15,58,10,10,10,10,10,10,10],
[9,9,9,9,9,123,118,9,9,9,9,9,9,9,9,9,19,20,9,9,9,9,9,9,9,9,9,9,9,9,9,9,9,9,9,9,9,9,9,9,58,10,10,10,10,10,10,10],
[9,9,9,9,9,117,131,9,9,9,9,9,9,9,9,9,22,23,24,9,9,9,9,9,9,9,9,9,9,9,9,9,9,9,9,9,9,9,9,9,58,10,10,10,10,10,10,10],
[9,9,9,9,9,9,9,9,9,9,9,9,9,16,9,9,28,29,9,9,9,9,9,9,9,9,9,9,9,9,9,9,9,9,9,9,9,9,9,9,58,10,10,10,10,10,10,10],
[9,9,9,9,9,9,9,9,9,11,9,9,9,9,9,9,9,45,9,9,9,9,9,9,9,9,9,9,9,9,9,9,9,9,9,9,118,116,9,9,58,10,10,10,10,10,10,10],
[9,9,9,9,9,9,9,9,112,118,131,9,9,9,9,9,43,71,9,9,9,9,9,9,9,9,9,9,9,9,9,9,9,9,9,9,112,111,9,9,58,10,10,10,10,10,10,10],
[9,9,9,9,9,9,9,119,115,113,111,9,9,9,43,56,71,111,9,9,9,9,9,9,9,9,9,9,9,9,9,9,9,132,108,117,114,132,9,9,58,10,10,10,10,10,10,10],
[9,9,9,9,9,9,9,109,112,116,111,9,9,9,45,115,113,111,9,9,9,9,9,9,9,9,9,9,9,9,9,9,9,9,9,9,9,9,9,9,58,10,10,10,10,10,10,10],
[9,9,9,9,9,9,9,120,117,114,110,9,9,9,44,133,114,110,9,9,9,9,9,9,9,9,9,9,9,9,9,9,9,9,9,9,9,9,9,9,58,10,10,10,10,10,10,10],
[9,9,9,9,9,9,9,9,116,133,9,9,9,43,71,114,110,9,9,9,9,9,9,9,9,9,9,9,9,9,9,9,9,9,9,9,9,9,9,16,58,10,10,10,10,10,10,10],
[9,9,9,15,9,9,9,9,9,9,9,9,9,45,108,131,9,9,9,9,9,9,9,9,9,9,9,9,9,9,9,9,9,9,9,9,9,9,9,14,58,10,10,10,10,10,10,10],
[9,9,9,9,9,9,9,9,9,16,9,9,19,20,9,9,9,9,9,9,9,9,9,9,9,9,9,9,9,9,9,9,9,9,9,9,9,9,9,9,58,10,10,10,10,10,10,10],
[11,9,9,9,9,9,9,9,9,9,9,9,22,23,24,9,9,9,9,9,9,9,9,9,9,9,9,9,9,9,9,9,9,9,9,9,9,9,9,9,62,33,10,10,10,10,10,10],
[113,118,9,9,9,9,9,15,9,9,9,9,28,29,9,9,9,9,9,9,9,9,9,9,9,9,9,9,9,9,9,9,9,9,9,9,9,9,9,9,9,58,10,10,10,10,10,10],
[114,131,9,9,9,9,9,9,9,9,9,9,9,44,9,9,9,9,9,9,9,9,9,9,9,9,9,9,9,9,9,9,9,9,9,9,9,9,9,9,9,62,33,10,10,10,10,10],
[111,9,9,9,9,9,9,9,116,131,9,9,9,78,55,133,9,9,9,9,116,11,9,9,9,9,9,9,9,9,9,9,9,9,9,9,9,9,9,9,9,133,58,10,10,10,10,10],
[132,9,9,9,9,9,119,70,87,111,9,9,9,9,45,118,70,87,118,70,87,118,11,9,9,9,9,9,9,9,9,9,9,9,9,9,9,9,9,9,112,111,62,33,10,10,10,10],
[9,9,9,9,9,9,112,113,112,118,9,9,9,9,78,55,120,112,117,116,113,112,113,132,9,9,9,9,9,9,9,9,9,9,9,9,9,9,87,112,113,118,113,58,10,10,10,10],
[9,9,9,9,9,9,112,112,116,115,112,9,9,9,9,78,55,9,120,112,115,114,108,115,131,9,9,9,9,9,112,116,9,9,9,9,9,132,114,108,108,117,131,58,10,10,10,10],
[9,9,9,132,9,9,120,113,116,113,118,132,9,9,9,9,78,79,55,131,114,59,60,117,112,118,9,9,9,132,108,114,9,21,9,9,43,57,56,57,56,57,76,77,10,10,10,10],
[9,131,9,9,9,9,9,120,108,117,112,111,9,9,9,9,9,132,78,80,76,77,35,60,132,110,9,9,133,43,57,56,25,26,27,57,71,9,9,9,133,117,131,82,10,10,10,10],
[9,9,9,9,9,9,9,9,9,121,122,110,9,9,9,9,9,118,70,70,132,82,10,74,75,57,56,57,56,71,9,9,30,31,32,9,9,9,9,9,9,120,117,62,33,10,10,10],
[9,9,9,9,9,9,9,9,9,41,42,9,9,9,9,119,87,112,113,114,110,58,10,81,9,9,9,9,9,9,9,9,9,9,9,9,9,9,9,9,9,9,120,132,58,10,10,10],
[9,9,9,9,9,16,9,9,9,9,9,9,9,15,9,112,112,112,133,111,59,34,36,61,9,9,9,112,118,11,9,9,9,9,9,131,117,113,118,11,9,9,9,133,58,10,10,10],
[9,9,9,9,9,9,9,9,9,9,9,9,9,9,119,113,112,115,112,131,62,89,61,9,9,9,112,112,113,112,114,110,9,9,9,9,120,108,112,118,70,11,9,9,58,10,10,10],
[9,9,9,9,9,9,9,9,9,9,9,9,9,9,112,112,112,112,114,110,9,88,9,9,9,112,113,112,112,108,110,9,9,9,9,9,9,132,112,113,112,118,9,9,58,10,10,10],
[9,9,9,9,9,9,9,9,9,9,9,9,9,112,112,132,115,112,43,80,79,71,9,9,9,116,112,115,132,9,9,9,9,9,9,9,15,9,112,112,113,114,9,9,58,10,10,10],
[9,9,9,9,9,9,9,9,9,9,9,15,9,132,112,131,114,110,73,9,9,9,9,9,117,112,112,114,9,9,9,9,9,9,9,9,9,9,133,115,113,110,9,9,58,10,10,10],
[9,9,9,9,9,9,9,9,9,9,9,9,9,9,117,110,9,19,20,9,9,9,9,9,9,120,116,9,9,9,9,9,9,9,9,9,9,9,9,112,114,9,9,59,34,10,10,10],
[112,132,116,9,9,9,9,9,9,9,9,9,9,9,9,9,9,22,23,24,9,9,9,9,9,9,9,9,9,15,9,9,9,9,9,9,9,9,9,116,132,9,9,58,10,10,10,10],
[115,112,111,9,9,9,9,9,9,9,9,9,9,9,9,9,9,28,29,9,9,9,9,9,9,9,9,9,9,9,9,9,9,9,9,9,9,9,9,9,9,9,59,34,10,10,10,10],
[116,112,118,131,9,9,9,9,9,9,9,9,9,9,9,9,119,131,73,9,9,9,9,9,9,113,131,9,9,9,9,9,9,9,9,9,9,9,9,9,9,9,58,10,10,10,10,10],
[112,132,112,118,11,9,9,9,9,9,9,9,9,9,9,112,113,111,72,131,9,9,9,9,112,113,110,9,9,9,9,9,9,9,9,9,9,9,9,9,9,9,58,10,10,10,10,10],
[116,112,115,113,111,9,9,9,9,9,9,9,9,9,132,116,112,111,73,132,133,9,9,9,115,111,9,9,9,9,9,9,9,9,9,9,9,9,9,9,9,9,58,10,10,10,10,10]]