[[9,70,71,9,84,9,103,9,9,9,9,95,96,9,84,9,9,9,9,9,9,9,9,103,9,9,9,138,9,9,9,9,9,102,9,9,9,9,9,9,9,9,95,96,9,9,102,9],
[9,81,82,9,93,94,9,9,9,9,9,104,105,9,9,9,9,9,9,9,9,9,9,9,9,9,9,9,9,9,9,9,9,9,9,9,9,9,9,9,9,116,104,105,9,9,9,9],
[102,9,9,117,102,103,9,9,9,9,9,9,9,9,9,9,9,9,9,9,9,9,9,93,94,9,9,9,9,9,9,9,9,9,70,94,9,9,9,9,9,9,9,9,9,9,9,9],
[9,9,9,9,9,9,9,9,9,9,9,9,138,9,72,94,9,9,9,9,9,9,9,102,103,9,9,9,9,9,9,9,9,9,102,103,117,9,9,9,9,9,9,9,9,9,9,9],
[9,9,9,9,9,9,9,9,9,9,9,72,73,9,81,105,9,9,9,9,9,116,72,73,9,116,9,9,9,9,9,95,96,9,9,9,70,73,9,9,9,9,9,9,9,9,9,9],
[9,9,9,9,9,139,9,9,9,9,9,83,84,9,9,9,9,9,9,9,70,96,83,84,9,9,117,9,9,9,9,104,105,9,9,9,104,103,72,94,9,9,9,9,70,71,9,84],
[9,9,9,9,9,9,9,9,70,96,9,9,9,116,9,9,9,70,71,9,102,84,9,9,9,9,9,9,9,70,96,116,9,9,9,9,9,9,81,105,9,9,9,9,81,82,9,9],
[9,9,9,9,9,9,9,9,102,84,139,9,95,96,9,9,117,81,82,9,9,116,9,9,9,9,9,9,9,102,84,9,9,9,9,9,9,93,94,9,9,9,9,9,9,9,9,9],
[9,9,116,9,117,9,9,117,116,117,116,9,104,105,70,73,117,138,117,129,97,70,73,9,93,94,9,9,9,9,93,96,9,93,94,9,9,102,103,9,9,72,94,9,9,9,9,9],
[9,9,95,96,9,9,9,137,70,71,139,137,93,96,104,103,116,72,94,106,107,104,93,96,102,103,70,96,95,96,83,82,9,102,103,9,70,96,9,9,9,81,105,9,9,9,72,73],
[9,116,104,105,9,9,72,94,81,82,103,116,83,82,9,70,96,81,105,96,70,71,83,82,9,9,102,84,104,105,139,72,73,72,94,9,102,84,95,96,9,9,9,9,9,9,83,84],
[9,9,9,116,9,9,81,105,9,9,9,84,9,9,9,102,84,9,72,73,81,82,9,9,9,93,94,9,9,70,96,83,84,81,105,70,71,116,104,105,9,9,137,138,9,9,9,9],
[9,9,9,9,9,9,9,70,73,9,9,9,9,93,94,9,9,9,83,84,9,9,9,117,9,102,103,9,9,102,84,9,9,128,74,81,82,139,70,73,93,96,9,9,9,139,9,9],
[9,9,9,9,9,9,9,104,103,9,116,9,9,102,103,9,9,9,9,9,9,137,9,9,9,116,9,9,70,71,9,9,9,85,86,117,93,96,104,103,83,82,9,9,9,9,9,117],
[9,9,9,9,9,9,9,9,9,9,9,117,9,9,9,9,117,9,70,73,9,9,9,9,9,72,73,9,81,82,9,95,96,9,70,94,83,82,72,94,9,9,9,9,9,9,9,9],
[9,9,9,9,9,9,9,70,96,72,72,73,9,9,9,9,9,9,104,103,9,72,94,9,9,83,84,9,9,9,9,104,105,9,102,103,95,96,81,105,9,9,9,9,9,9,9,9],
[9,9,9,9,9,116,9,102,84,81,83,84,9,9,70,96,9,9,9,9,9,81,105,9,9,9,9,9,9,9,9,9,9,116,9,9,104,105,9,9,9,9,9,9,9,9,9,9],
[96,9,9,70,71,138,93,94,116,9,9,9,9,9,102,84,9,9,9,9,70,71,9,93,96,9,117,9,9,93,94,9,9,9,9,9,9,72,73,9,9,9,9,9,9,9,9,9],
[105,9,9,81,82,116,102,103,117,9,9,9,9,95,96,9,9,9,129,97,81,82,9,83,82,9,9,9,9,102,103,9,137,9,117,9,9,83,84,9,9,138,9,9,9,9,9,9],
[9,9,9,9,9,70,73,138,116,9,9,9,9,104,105,72,94,9,106,107,9,9,9,9,9,9,9,9,9,9,9,9,9,9,9,93,94,117,93,96,9,9,9,9,9,9,116,9],
[116,72,73,9,9,104,103,116,95,96,117,117,9,9,9,81,105,9,9,9,9,9,95,96,9,9,9,117,9,9,9,9,72,73,9,102,103,116,83,82,9,9,9,9,72,94,9,9],
[9,83,84,9,9,137,93,96,104,105,117,70,71,9,9,9,9,9,9,9,9,9,104,105,9,116,9,9,9,116,9,9,83,84,9,9,70,96,70,71,9,9,72,73,81,105,9,9],
[9,9,9,9,9,9,83,82,117,138,117,81,82,9,9,117,9,9,9,9,9,9,9,9,9,9,9,9,9,9,9,70,73,9,9,9,102,84,81,82,116,9,83,84,96,95,96,9],
[9,103,9,9,9,9,72,94,116,70,96,9,9,9,9,9,116,9,9,9,9,9,9,9,9,9,9,9,70,96,9,104,103,9,9,72,94,116,9,9,70,94,117,9,9,104,105,9],
[9,9,9,9,9,9,81,105,117,102,84,9,9,9,9,9,9,9,9,9,9,9,9,9,9,9,9,9,102,84,9,9,9,70,96,81,105,95,96,9,102,103,9,9,9,9,9,9],
[9,9,9,9,9,9,137,93,94,117,9,9,9,9,9,9,128,74,9,9,9,9,9,9,9,9,9,9,9,9,9,9,9,102,84,9,9,104,105,9,9,9,9,9,9,9,9,71],
[9,9,9,9,9,9,9,102,103,116,9,9,9,93,94,9,85,86,9,9,9,9,9,9,9,9,9,9,9,93,96,9,9,116,9,9,72,73,70,73,9,9,9,9,9,9,9,9],
[9,9,9,9,9,9,70,94,72,73,9,9,9,102,103,9,95,96,9,9,9,9,9,9,9,9,9,9,9,83,82,9,9,9,9,9,83,84,104,103,117,9,9,9,9,9,9,9],
[71,9,9,9,9,9,102,103,83,84,9,9,9,9,9,117,104,105,9,9,9,93,94,9,9,9,9,9,9,9,9,9,9,9,116,9,9,9,9,93,94,9,9,9,9,9,9,9],
[9,9,9,9,9,117,70,73,116,95,96,9,9,138,9,9,9,9,9,9,9,102,103,9,9,9,9,128,74,9,9,95,96,9,9,9,9,9,9,102,103,9,9,9,9,9,9,84],
[9,9,9,137,9,9,104,103,117,104,105,9,9,9,9,9,9,9,72,73,9,9,9,9,9,9,9,85,86,9,9,104,105,9,9,70,71,137,70,96,116,9,9,9,9,9,9,9],
[138,9,9,9,9,9,9,70,71,9,9,9,9,9,70,73,9,9,83,84,9,9,9,9,9,116,9,9,9,9,9,9,9,9,9,81,82,9,102,84,9,9,9,9,9,9,117,9],
[73,9,9,9,9,93,96,81,82,9,9,9,9,9,104,103,9,9,9,9,9,9,70,96,9,9,9,9,9,9,72,94,116,9,9,9,9,9,95,96,9,9,9,9,9,139,95,96],
[84,9,9,9,9,83,82,9,9,9,9,9,9,9,9,9,9,9,9,72,94,9,102,84,9,9,9,9,9,9,81,105,117,9,138,9,9,9,104,105,9,9,9,9,9,9,104,105],
[9,139,9,9,70,73,117,70,96,9,72,73,9,9,9,9,93,94,9,81,105,9,9,9,9,93,94,9,9,9,9,9,9,9,9,9,116,9,9,9,9,9,70,116,71,9,9,9],
[9,9,9,9,104,103,116,102,105,9,83,84,9,9,9,9,102,103,9,9,9,117,9,70,73,102,103,9,9,9,9,70,71,9,9,93,96,9,9,72,94,9,9,9,9,9,9,9],
[9,9,9,137,9,95,96,128,74,9,9,9,9,93,96,9,9,9,9,9,9,9,9,104,103,9,9,9,9,9,9,81,82,9,9,83,82,93,94,81,105,9,9,9,9,9,9,9],
[9,9,9,9,9,104,105,85,86,9,9,9,9,83,82,9,9,9,9,9,9,9,9,9,9,9,70,94,9,9,9,9,9,9,9,129,97,102,103,70,73,138,9,9,9,9,9,9],
[9,9,9,9,9,9,72,96,137,9,9,9,9,9,9,9,9,72,73,9,70,94,9,9,9,9,102,103,9,9,9,128,74,70,73,106,107,116,117,104,103,117,9,9,9,9,9,9],
[9,9,9,9,9,9,102,105,117,84,70,71,93,96,93,94,9,83,84,9,102,103,95,96,9,9,9,72,73,72,94,85,86,104,103,117,70,96,72,73,117,93,94,9,9,9,9,9],
[9,9,9,9,9,9,70,94,93,94,81,82,83,82,102,103,72,94,139,70,71,117,104,105,70,96,139,83,84,81,105,116,93,96,95,96,102,84,83,84,117,102,103,117,9,9,72,73],
[9,9,9,9,9,9,102,103,102,103,137,95,96,9,9,116,81,105,116,81,82,116,116,117,102,84,70,73,9,116,9,9,83,82,104,105,9,9,9,9,137,9,9,9,9,9,83,84],
[9,9,9,9,9,95,96,9,9,70,96,104,105,9,9,9,9,70,73,116,117,116,116,93,94,117,104,103,9,9,117,9,9,9,9,9,9,9,9,9,9,9,9,9,9,9,9,93],
[9,9,9,70,9,104,105,9,9,102,84,9,9,9,103,9,9,104,103,116,70,96,117,102,103,116,117,9,9,9,9,9,9,70,9,9,9,9,9,9,9,9,9,9,9,9,70,73],
[9,9,9,9,9,9,9,9,9,9,9,9,9,9,9,9,116,9,9,117,102,84,116,9,9,117,9,9,9,9,9,9,9,9,9,9,9,9,9,9,103,9,9,9,9,9,104,103],
[9,9,9,72,73,139,9,9,71,9,9,9,9,9,9,70,71,9,9,9,9,9,9,72,73,9,9,9,137,9,9,9,9,70,71,9,9,9,9,9,9,9,9,9,9,9,139,84],
[9,9,9,83,84,9,9,9,9,9,9,9,9,9,9,81,82,9,9,9,9,9,9,83,84,9,9,9,95,96,9,9,9,81,82,9,9,9,9,9,9,9,9,9,9,9,70,71],
[9,84,9,9,9,9,9,9,9,9,9,9,9,9,9,9,9,9,9,9,9,9,9,9,9,102,9,9,104,105,9,9,9,9,9,9,72,73,9,9,117,9,9,9,103,9,81,82]]