[[9,9,9,9,9,9,9,9,9,9,9,9,9,9,9,9,9,9,9,9,9,9,9,135,12,12,12,12,12,12,12,12,12,12,12,75,76,140,140,119,140,120,140,140,119,140,140,119],
[9,9,9,10,9,9,9,9,9,9,11,9,9,9,9,9,11,9,9,9,9,9,9,134,12,12,12,12,12,12,12,12,12,12,12,87,88,119,119,119,140,140,119,140,140,119,140,140],
[9,9,9,9,9,9,9,9,9,9,9,11,9,9,9,9,9,9,9,10,9,9,9,135,12,12,12,12,12,12,12,12,12,12,12,98,99,9,120,119,119,120,119,9,120,119,119,140],
[9,9,9,9,9,9,9,9,9,9,11,9,9,9,9,9,9,9,9,13,9,9,9,135,12,12,12,12,12,12,12,12,12,12,12,75,76,10,9,9,120,9,9,9,9,9,140,119],
[9,9,9,9,9,9,9,9,9,9,9,9,9,11,9,9,9,9,11,9,9,9,9,136,12,12,12,12,12,12,12,12,12,12,12,59,60,9,9,9,9,9,10,11,11,120,119,140],
[9,11,9,9,9,9,11,9,9,9,9,9,9,11,9,10,9,9,9,9,9,9,9,125,12,12,12,12,12,12,12,12,12,12,12,12,12,132,100,101,9,9,9,9,9,120,119,140],
[9,10,9,9,9,9,9,9,9,9,9,9,9,9,9,9,9,9,9,9,9,130,126,127,12,12,12,12,12,12,12,12,12,12,12,12,12,12,98,99,9,9,11,9,9,9,119,119],
[9,9,9,9,9,9,9,9,9,9,9,9,9,35,9,9,9,9,9,9,9,136,12,12,12,12,12,12,12,12,12,12,12,12,12,12,12,12,87,88,9,13,9,10,11,9,120,140],
[9,9,9,9,9,9,9,11,10,9,9,10,11,11,9,9,9,9,9,9,9,135,12,12,12,12,12,12,12,12,12,12,12,12,12,12,12,12,87,88,9,11,9,9,9,9,9,119],
[9,9,9,9,9,9,9,9,9,9,9,9,9,9,9,9,9,9,9,9,9,80,78,79,78,33,12,12,12,12,12,12,12,12,12,12,12,12,75,76,9,9,9,9,10,9,120,119],
[9,9,9,9,9,9,9,9,9,9,9,9,10,9,9,9,9,9,9,9,9,92,90,91,90,45,12,12,12,12,12,12,12,12,12,12,12,12,98,99,9,9,9,11,9,9,9,120],
[9,10,9,9,9,9,9,9,9,9,10,9,9,9,9,9,9,9,9,9,9,9,9,9,9,9,135,12,12,12,12,12,12,12,31,32,78,79,108,109,9,9,9,9,10,9,9,9],
[9,11,9,9,9,9,10,10,9,9,9,11,9,9,9,9,9,9,9,9,9,9,9,9,9,9,136,12,12,12,12,12,12,12,43,44,90,91,114,115,9,9,10,9,35,9,9,9],
[9,9,9,9,9,11,9,9,9,9,9,11,9,9,9,9,9,9,9,9,9,10,9,9,9,9,134,12,12,12,12,12,12,12,75,76,9,9,9,9,11,9,9,9,9,9,9,9],
[9,9,9,9,10,11,9,9,9,9,9,9,9,9,9,9,9,10,10,9,9,11,11,9,9,9,136,12,12,12,12,12,12,12,87,88,9,11,9,9,9,9,120,9,9,120,10,9],
[9,9,9,9,11,9,9,10,9,9,9,9,9,9,9,9,9,9,9,9,9,9,9,9,9,9,135,12,12,12,12,28,29,77,108,109,9,9,9,9,10,9,9,119,119,9,9,9],
[9,9,9,9,9,9,9,9,9,9,9,9,9,10,9,9,9,9,9,9,9,13,9,9,9,9,134,12,12,12,12,40,41,89,114,115,9,9,9,10,9,120,119,140,119,140,119,120],
[9,10,9,9,9,9,9,9,9,9,9,9,9,9,11,10,9,9,9,9,9,9,9,9,9,9,122,12,12,12,12,87,88,13,10,9,9,11,130,133,131,132,100,101,140,119,140,119],
[9,10,9,9,9,9,9,9,9,9,9,9,9,9,9,9,9,9,9,9,130,132,131,132,133,123,124,12,12,12,12,75,76,9,9,9,9,9,135,12,12,12,59,60,119,140,140,119],
[9,11,9,9,9,9,9,9,9,11,10,9,9,9,9,9,9,9,9,9,135,12,12,12,12,12,12,12,12,12,12,98,99,9,9,11,9,9,135,12,12,12,12,12,131,133,132,132],
[9,9,35,9,9,9,9,9,9,9,9,9,9,9,9,9,9,9,9,9,136,12,12,12,12,12,12,12,12,12,12,75,76,9,10,11,9,9,125,12,12,12,12,12,12,12,12,12],
[9,9,9,9,9,10,9,9,9,9,9,9,9,9,9,9,10,9,9,9,134,12,12,12,12,12,12,12,12,12,12,87,88,9,11,9,130,126,127,12,12,12,12,12,12,12,12,12],
[9,9,9,9,9,11,10,9,9,9,9,9,9,9,9,9,9,9,9,9,122,12,12,12,12,12,12,12,12,31,32,108,109,9,9,9,125,12,12,12,12,12,12,12,12,12,12,12],
[131,100,101,9,9,9,11,10,9,9,9,130,132,100,101,9,10,9,130,123,124,12,12,12,12,12,12,12,12,43,44,114,115,11,130,123,124,12,12,12,12,12,12,12,12,12,12,12],
[12,59,60,9,9,9,9,9,9,13,9,135,12,87,88,9,9,9,136,12,12,12,12,12,12,12,12,12,12,75,76,35,9,9,136,12,12,12,12,12,12,12,12,12,12,12,12,12],
[12,12,12,100,101,9,9,9,9,9,9,125,12,98,99,9,9,9,80,78,79,33,12,12,12,28,29,77,79,108,109,9,9,9,135,12,12,12,12,12,12,12,12,12,12,12,12,12],
[12,12,12,87,88,11,130,131,132,131,126,127,12,75,76,10,9,9,92,90,91,45,12,12,12,40,41,89,91,114,115,9,11,9,134,12,12,12,12,12,12,12,12,12,12,12,12,12],
[79,77,78,108,109,9,135,12,12,12,12,12,12,59,60,9,9,10,9,9,13,9,80,78,79,108,109,9,10,138,9,9,9,10,125,12,12,12,12,12,12,12,12,12,12,12,12,12],
[91,89,90,114,115,13,136,12,12,12,12,12,12,12,12,100,101,9,11,10,9,9,92,90,91,114,115,9,9,9,130,132,133,126,127,12,12,12,12,12,12,12,12,12,12,12,12,12],
[37,50,54,50,54,64,135,12,12,12,12,12,12,12,12,75,76,9,9,9,9,9,9,9,9,9,9,11,10,9,135,12,12,12,12,12,12,12,12,12,12,12,12,12,12,12,12,12],
[132,132,131,100,101,51,80,77,77,78,33,12,12,31,32,108,109,10,9,11,9,10,9,9,10,9,9,10,9,9,136,12,12,12,12,12,12,12,12,12,12,12,12,12,12,12,12,12],
[12,12,12,87,88,55,92,89,89,90,45,12,12,43,44,114,115,9,9,9,10,9,9,10,9,9,9,9,9,9,80,78,33,12,12,12,12,12,12,12,12,12,12,12,12,12,12,12],
[12,12,12,59,60,62,54,37,50,64,11,80,78,108,109,9,9,9,11,9,9,9,11,9,9,9,9,9,11,9,92,90,45,12,12,12,12,12,12,12,12,12,12,12,12,12,12,12],
[12,12,12,12,12,133,132,100,101,62,64,92,90,114,115,9,11,10,9,9,9,10,9,9,10,9,10,9,9,9,9,13,9,135,12,12,12,12,12,12,12,12,12,12,12,12,12,12],
[12,12,12,12,12,12,12,75,76,9,62,64,9,9,9,9,10,9,9,9,9,9,10,9,11,9,9,9,9,10,9,10,9,136,12,12,12,12,12,12,12,12,12,12,12,12,12,12],
[77,78,79,77,79,77,78,108,109,9,9,20,9,9,11,9,10,130,131,131,100,101,9,9,9,10,11,9,9,11,9,9,9,125,12,12,12,12,12,12,28,29,78,77,79,77,78,79],
[89,90,91,89,91,89,90,114,115,9,21,22,23,9,9,9,9,134,12,12,87,88,9,9,9,9,9,10,9,9,130,133,126,127,12,12,12,12,12,12,40,41,90,89,91,89,90,91],
[9,9,9,9,9,9,9,9,9,10,9,24,9,9,9,9,9,136,12,12,98,99,9,10,35,10,9,10,10,9,134,12,12,12,12,12,12,12,12,12,75,76,119,119,120,120,9,10],
[120,9,11,9,9,9,11,9,9,9,9,62,37,54,50,37,64,135,12,12,59,60,9,9,9,9,9,9,9,9,80,33,12,12,12,12,31,32,77,79,108,109,120,140,119,9,11,9],
[119,9,9,9,9,35,9,9,9,13,9,9,9,13,9,9,51,134,12,12,12,12,132,133,131,133,100,101,139,137,92,45,12,12,12,12,43,44,89,91,114,115,119,119,120,10,9,9],
[120,9,11,9,9,9,9,9,9,11,9,10,9,130,100,101,55,80,77,78,79,33,12,12,12,12,87,88,9,10,9,9,80,78,77,79,108,109,9,9,9,120,9,120,11,120,9,120],
[140,119,120,9,9,9,9,11,9,9,9,130,126,127,75,76,38,92,89,90,91,45,12,12,12,12,98,99,9,9,9,9,92,90,89,91,114,115,9,10,9,9,9,9,9,9,120,119],
[140,140,119,9,9,9,9,9,9,9,120,134,12,12,87,88,62,50,64,9,35,9,135,12,12,12,75,76,9,10,9,9,9,9,9,9,9,9,9,9,9,10,11,9,9,9,119,140],
[120,140,119,9,9,9,10,9,9,120,119,136,12,12,59,60,13,9,62,50,37,64,136,12,12,12,87,88,9,9,11,10,9,10,9,9,9,11,9,10,9,9,9,10,120,120,119,119],
[140,119,9,9,11,9,9,9,9,120,140,135,12,12,12,12,132,131,133,100,101,51,134,12,12,12,98,99,10,9,9,9,9,9,10,9,9,9,9,9,9,9,10,9,119,119,140,140],
[119,120,9,13,9,9,9,9,9,9,140,134,12,12,12,12,12,12,12,75,76,55,80,77,78,79,108,109,11,9,9,9,9,9,9,9,9,9,11,9,9,9,120,119,119,119,140,119],
[120,9,11,9,9,9,9,9,119,140,120,136,12,12,12,12,12,12,12,87,88,38,92,89,90,91,114,115,10,9,119,9,9,9,11,9,9,9,9,9,9,119,119,140,140,140,121,140],
[9,9,9,9,10,9,120,119,140,140,140,134,12,12,12,12,12,12,12,98,99,51,11,35,9,11,117,9,9,119,10,9,119,9,9,9,11,9,9,120,119,140,140,140,119,140,140,120]]