[[115,113,118,87,115,118,116,114,113,117,115,118,116,112,114,115,117,112,87,113,133,110,9,9,9,9,120,117,116,112,87,118,115,114,132,132,115,117,113,113,114,112,132,115,116,113,87,116],
[116,115,112,113,112,113,115,112,133,116,112,133,114,113,131,113,115,118,115,112,9,9,9,9,9,9,9,9,120,115,116,113,112,115,116,113,115,115,116,114,110,133,116,112,115,112,115,117],
[114,113,116,115,114,116,87,116,113,114,115,113,118,117,115,112,116,113,112,9,9,9,9,9,9,9,9,9,87,116,113,116,113,113,115,112,113,116,114,110,9,117,112,116,113,116,112,131],
[113,112,117,112,115,112,115,113,115,131,116,87,112,116,114,115,87,112,116,133,9,9,9,9,9,9,9,119,112,115,112,112,115,116,113,116,113,115,112,9,9,9,9,120,116,115,116,113],
[87,114,113,116,113,116,114,112,87,115,112,116,115,113,112,116,113,110,9,9,9,9,9,9,9,9,119,87,115,113,116,113,113,112,115,115,116,115,11,9,9,9,9,9,117,113,112,87],
[116,110,117,112,110,120,112,114,117,118,113,115,112,116,112,114,120,112,9,9,9,9,9,9,9,119,112,115,115,116,113,112,116,113,115,116,114,131,114,9,9,9,9,9,120,116,113,115],
[112,9,9,132,9,120,9,9,113,112,115,116,116,114,110,9,9,9,9,9,9,9,9,9,9,113,115,116,113,116,115,113,116,115,115,113,133,120,132,9,9,9,9,9,87,87,113,116],
[110,133,9,9,9,9,9,133,9,116,118,112,115,113,9,9,9,9,9,9,9,9,119,11,119,115,113,116,112,116,116,113,116,116,116,115,112,9,9,9,9,9,9,9,119,116,115,114],
[9,9,9,9,9,9,9,9,9,120,113,115,112,110,131,9,9,9,9,132,119,116,113,118,116,112,112,113,115,113,112,116,113,112,116,113,115,9,9,14,9,9,9,9,132,120,116,112],
[9,9,9,9,9,9,9,9,9,132,117,112,113,111,9,9,9,9,9,9,112,113,115,116,113,116,112,116,116,116,116,115,113,116,115,116,113,11,9,9,9,9,9,9,9,9,119,113],
[9,9,9,9,9,9,9,9,9,9,113,116,115,11,9,9,9,9,9,87,113,115,113,112,115,116,115,115,113,115,116,113,116,116,116,116,115,113,116,9,13,9,9,9,119,87,87,112],
[9,9,9,9,9,9,9,9,9,112,116,87,112,112,11,9,9,9,9,112,120,116,110,117,112,115,116,113,116,115,115,116,112,116,115,115,112,116,110,9,9,9,9,9,115,119,113,114],
[9,9,9,9,9,9,9,9,13,9,113,112,116,114,110,9,9,9,14,15,9,9,9,109,115,113,112,116,112,116,115,113,115,112,116,114,108,110,9,9,9,9,9,115,113,115,112,116],
[9,9,9,9,9,9,9,9,9,9,115,116,115,113,9,9,9,9,9,9,9,9,9,120,113,116,113,115,113,116,115,113,116,115,110,9,9,9,9,9,9,116,131,116,112,118,113,132],
[9,9,9,9,9,9,9,9,9,9,112,114,112,110,9,9,9,9,9,9,9,9,9,9,116,116,115,116,116,113,115,115,115,112,132,9,9,9,9,119,113,112,133,112,113,116,112,115],
[119,131,9,9,9,9,9,9,9,119,87,115,113,111,9,9,9,9,9,9,9,9,9,131,119,112,115,115,112,115,113,116,114,110,9,9,9,9,9,116,112,115,113,115,112,112,113,87],
[132,110,9,9,9,9,9,9,119,115,113,112,114,9,9,9,9,9,9,9,9,9,119,118,120,115,115,113,115,110,9,133,9,9,9,9,9,9,9,131,115,113,116,112,116,113,115,113],
[116,11,133,9,9,9,9,9,116,112,115,114,9,9,9,9,9,9,9,9,9,9,120,113,115,112,113,115,115,111,9,9,9,9,9,9,9,9,9,9,117,112,116,113,114,115,112,112],
[114,112,119,11,9,9,9,9,132,115,118,110,9,9,9,9,9,9,9,9,9,131,119,115,113,116,115,113,114,111,9,9,9,9,9,9,9,9,9,9,9,120,117,115,112,113,116,115],
[131,115,132,118,9,9,9,9,9,9,15,9,9,9,9,9,9,9,9,9,119,87,113,116,112,115,115,117,110,9,9,9,9,9,9,9,9,9,9,9,9,9,120,117,116,112,115,117],
[116,113,113,116,119,112,9,9,9,9,9,9,9,9,9,9,9,9,9,9,120,116,115,112,115,113,110,9,9,9,9,9,9,9,9,9,9,9,9,9,9,9,9,115,113,114,113,116],
[115,112,116,115,112,110,9,9,9,9,9,9,9,9,9,9,9,9,9,9,132,117,116,113,120,112,115,9,9,9,9,9,9,9,9,9,9,9,9,9,9,9,17,133,116,110,120,109],
[113,112,113,116,115,11,9,9,9,9,9,9,9,9,9,9,9,9,9,9,9,9,132,110,9,115,116,118,9,9,9,9,9,9,9,9,9,9,9,9,9,15,9,9,9,119,70,87],
[87,116,115,116,112,113,133,9,9,9,9,9,9,9,9,9,9,9,9,9,9,9,9,9,9,9,133,16,9,9,9,9,9,9,9,9,132,133,9,9,9,9,9,9,9,109,112,114],
[112,113,112,113,115,116,116,112,133,9,9,14,9,9,9,9,9,9,9,9,9,9,9,9,9,9,9,9,9,9,9,9,9,9,9,9,87,116,118,9,9,9,9,9,9,120,117,116],
[113,116,112,133,113,112,113,117,132,9,87,9,9,9,9,9,9,9,9,9,9,9,9,9,9,9,9,9,9,9,9,9,9,9,9,131,116,113,115,11,9,9,9,9,116,70,87,87],
[114,113,116,112,87,115,116,118,113,133,116,9,9,9,9,9,9,9,9,9,9,9,9,9,9,9,9,9,9,9,9,9,9,9,9,9,117,115,112,116,132,9,9,9,131,117,116,112],
[116,133,132,115,112,113,112,116,115,116,110,119,131,133,9,9,9,9,9,9,9,9,9,9,9,9,9,9,9,9,9,9,9,9,9,9,9,87,113,115,118,112,9,9,9,120,117,115],
[113,112,116,131,113,133,87,117,112,114,116,87,115,113,9,9,9,9,9,9,9,9,9,9,9,9,9,9,9,9,9,9,9,9,9,9,132,115,112,113,115,11,9,9,9,9,109,118],
[87,132,115,113,112,132,112,116,113,118,11,113,116,115,17,15,9,9,9,9,9,9,9,9,9,9,9,9,9,9,9,9,9,9,9,9,9,9,112,116,112,116,9,9,9,9,116,113],
[115,112,87,116,131,115,113,118,132,116,9,9,9,9,9,9,9,9,9,9,9,9,9,9,9,9,9,9,9,9,9,9,9,9,9,9,9,9,9,115,113,110,9,9,9,9,109,131],
[110,115,112,132,115,112,131,113,131,118,9,9,9,9,9,9,9,9,9,9,9,9,9,9,9,9,9,9,9,9,9,9,9,9,9,9,9,9,116,113,115,133,9,9,9,9,120,117],
[113,116,133,116,131,113,115,133,113,113,9,9,9,9,9,9,9,9,9,9,9,9,9,9,9,9,9,9,9,9,9,9,9,9,9,9,14,9,9,112,113,112,9,9,9,9,133,109],
[131,115,131,113,116,112,132,118,131,87,9,9,9,9,9,9,9,9,9,9,9,9,9,9,9,9,9,9,9,9,9,9,9,9,9,9,9,15,9,115,112,116,132,13,9,9,119,87],
[116,112,115,133,115,116,113,113,133,115,9,9,9,9,9,9,9,9,9,9,9,9,9,9,9,9,9,9,9,9,9,9,9,9,13,9,9,9,9,9,9,9,9,16,9,9,109,115],
[133,131,116,113,131,113,131,117,131,116,9,9,9,9,9,9,9,9,9,9,9,9,9,9,9,9,9,9,9,9,9,9,9,114,110,119,9,119,112,87,113,115,9,9,9,9,109,131],
[11,116,113,131,115,116,115,131,113,11,9,9,9,9,9,9,9,9,9,9,9,9,9,9,9,9,9,9,9,9,9,9,9,87,112,118,87,116,113,116,115,110,9,9,133,70,87,113],
[115,112,131,113,133,131,87,113,116,110,9,9,9,9,9,9,9,9,9,9,9,9,9,9,9,9,9,9,9,9,9,9,9,116,114,113,112,113,115,114,9,9,9,9,113,116,112,114],
[114,113,115,132,116,116,133,131,133,115,9,9,9,9,9,9,9,9,9,9,9,9,9,9,9,9,9,9,9,9,9,9,9,112,112,116,113,116,118,11,9,9,9,9,120,117,113,116],
[87,116,131,113,87,113,131,116,131,113,9,9,9,9,9,9,9,9,9,9,9,9,9,9,9,9,9,9,9,9,9,9,9,119,117,113,114,112,113,115,9,9,9,9,9,112,115,87],
[116,132,115,131,132,131,116,132,116,131,9,9,9,9,9,9,9,9,9,9,9,9,9,9,9,9,9,9,9,9,9,9,9,112,116,133,113,113,116,9,9,9,9,9,9,9,117,113],
[113,112,87,116,133,132,116,117,132,116,9,9,9,9,9,9,9,9,9,9,9,9,9,9,9,9,9,9,9,9,9,9,9,113,118,112,116,115,9,9,9,9,9,9,9,131,109,112],
[132,133,131,116,131,115,112,131,115,113,112,113,11,115,117,114,131,116,118,113,112,116,118,87,112,114,116,112,113,119,116,112,116,87,116,113,132,114,9,9,9,9,9,9,9,9,115,117],
[115,132,115,112,113,112,87,113,131,87,133,87,112,132,112,116,115,115,132,112,116,133,113,114,113,112,133,113,112,113,112,132,113,112,112,116,115,110,9,9,9,9,9,9,9,9,9,120],
[133,112,87,115,116,115,132,118,113,115,112,113,116,131,116,115,113,112,87,116,112,116,112,132,115,113,87,116,113,133,116,112,132,116,113,112,115,11,9,9,9,9,9,9,9,9,9,9],
[87,116,112,113,115,112,115,116,115,115,112,116,113,87,116,133,112,116,112,115,113,115,113,112,116,112,115,112,116,87,112,87,115,112,116,115,118,9,9,11,9,9,9,9,9,9,9,9],
[113,112,113,132,112,113,115,115,112,132,116,112,115,112,132,116,115,115,116,115,112,113,112,113,112,132,115,113,112,115,132,116,133,113,132,112,116,11,87,9,9,9,9,9,9,9,9,9],
[120,115,114,112,116,132,113,87,115,117,113,87,112,114,115,117,113,11,116,87,116,112,119,115,117,116,132,113,87,116,114,112,113,117,116,87,113,112,115,11,9,9,9,9,9,9,9,9]]