[[109,110,111,110,107,110,109,107,106,107,109,111,110,107,108,107,106,105,106,107,108,109,111,106,110,85,85,108,109,111,70,80,110,86,9,9,9,9,9,14,9,9,9,9,12,9,9,9],
[106,107,106,107,85,96,106,110,108,110,106,85,105,85,96,17,96,85,110,96,106,108,85,96,97,9,10,95,96,96,97,122,109,9,9,9,9,9,9,9,9,16,9,9,9,9,9,9],
[109,108,86,9,9,9,95,111,109,96,86,10,9,9,9,9,9,10,9,9,95,97,9,9,9,9,9,9,9,9,24,25,26,10,9,9,9,10,9,9,9,9,9,9,9,9,9,9],
[106,97,9,9,11,9,9,84,97,9,9,9,9,9,9,9,9,9,9,9,9,9,9,9,9,9,9,9,9,9,9,123,9,9,43,109,9,9,12,9,9,9,9,10,9,9,9,12],
[70,9,13,10,9,9,9,9,9,17,9,9,9,9,9,9,9,9,9,9,9,9,10,9,9,9,9,9,9,9,10,80,17,108,107,109,45,9,9,9,43,45,9,9,9,9,9,9],
[109,9,9,9,43,60,9,10,18,9,9,9,9,9,10,9,9,9,9,9,9,9,9,9,9,16,9,9,9,9,9,101,102,93,106,85,109,10,9,9,69,107,60,9,9,9,9,9],
[71,9,9,58,107,106,44,59,44,109,9,9,9,9,9,11,9,9,9,9,13,9,9,9,9,9,9,9,9,9,9,9,9,94,86,9,9,9,9,111,108,109,110,45,9,9,9,14],
[70,9,15,95,111,110,111,110,85,9,9,9,9,9,9,9,9,9,9,9,9,9,9,9,9,9,9,9,9,14,9,9,9,80,10,9,11,9,9,9,111,107,108,109,109,9,9,9],
[71,9,9,9,84,106,107,97,9,9,9,13,9,9,9,9,9,9,9,12,9,9,9,9,9,9,9,9,9,9,9,9,9,122,9,9,9,9,9,9,69,106,111,108,97,9,9,9],
[106,60,9,11,9,69,70,9,9,9,10,9,9,9,9,9,9,9,9,9,9,9,9,9,9,10,9,9,9,9,9,9,24,25,26,9,13,9,9,9,68,111,107,86,9,9,10,9],
[109,107,45,10,9,95,109,9,9,9,11,9,9,9,9,9,9,9,9,9,9,9,9,9,9,9,9,9,15,9,9,10,9,123,9,9,9,9,9,9,69,107,106,10,9,11,9,9],
[110,108,97,9,9,9,18,9,9,9,13,9,9,9,9,9,9,9,12,9,9,9,9,9,14,9,9,9,9,9,9,9,9,80,18,9,9,9,9,111,95,110,97,9,9,9,13,9],
[111,86,9,9,9,17,9,9,9,9,9,12,9,9,9,9,9,9,9,9,9,9,9,9,9,9,9,9,9,9,9,9,81,104,10,17,9,9,9,9,9,111,9,9,9,9,9,9],
[106,9,9,9,9,9,19,9,9,9,9,9,9,9,9,9,9,9,9,9,9,9,9,9,9,9,9,9,9,9,9,81,104,19,17,9,9,9,9,9,9,9,9,9,9,10,9,9],
[97,9,9,12,9,18,9,9,15,9,9,9,14,9,9,9,9,9,9,9,9,9,10,9,9,9,9,9,9,10,81,104,18,17,9,9,10,9,9,9,9,9,9,9,9,9,12,9],
[10,9,13,9,43,109,9,9,9,9,9,9,9,9,9,9,10,9,9,9,9,9,9,9,9,9,9,9,9,9,80,19,17,9,17,13,9,9,58,60,110,9,9,9,9,9,9,9],
[12,9,9,58,106,71,9,16,9,9,9,9,9,9,9,9,9,11,9,9,9,28,65,65,65,65,65,65,65,65,66,67,35,19,9,9,9,43,107,70,10,9,9,12,15,9,9,9],
[15,9,43,108,107,70,9,9,9,9,9,9,9,9,9,9,9,9,9,28,65,53,42,42,42,42,42,42,42,42,42,42,42,79,9,9,58,109,108,70,9,11,9,9,9,9,9,9],
[9,9,106,109,106,18,9,9,9,9,12,9,9,9,9,9,9,9,9,56,42,42,42,42,42,42,42,42,42,42,42,42,42,79,9,9,68,107,106,70,9,9,9,9,16,9,9,9],
[9,9,95,108,107,71,9,9,10,9,9,9,9,9,9,13,9,10,28,53,42,42,42,42,42,42,42,42,42,42,42,42,42,79,9,9,95,106,108,106,60,9,9,9,9,9,9,9],
[9,9,9,68,109,70,9,9,9,9,9,9,9,9,9,9,9,9,56,42,42,42,42,42,42,42,42,42,42,42,42,42,42,33,35,9,10,84,111,107,70,9,9,9,9,9,9,9],
[9,14,9,69,108,105,9,9,9,9,9,9,9,9,9,9,28,65,53,42,42,42,42,42,42,42,42,42,42,42,42,42,42,42,42,79,9,9,69,109,110,45,9,9,9,9,9,9],
[9,9,10,68,107,108,45,9,9,9,9,11,9,9,9,28,53,42,42,42,42,42,42,42,42,42,42,42,42,42,42,42,42,42,42,79,9,9,68,108,106,110,109,12,9,9,9,9],
[9,9,11,95,109,106,71,9,9,9,9,9,9,9,9,56,42,42,42,42,42,42,42,42,42,42,42,42,42,42,42,42,42,42,42,79,9,9,95,107,111,85,108,9,9,9,10,9],
[9,9,13,9,68,107,70,9,9,10,9,9,9,9,9,56,42,42,42,42,42,42,42,42,42,42,42,42,42,42,42,42,42,42,42,79,9,9,9,109,97,9,9,9,9,13,9,58],
[45,9,9,9,69,108,19,9,9,9,9,9,9,9,9,56,42,42,42,42,42,42,42,42,42,42,42,42,42,42,42,42,42,42,42,79,9,9,9,9,9,15,9,9,9,9,43,106],
[108,60,9,9,68,106,109,60,9,9,12,9,13,9,9,56,42,42,42,42,42,42,42,42,42,42,42,42,42,42,42,42,42,42,42,79,9,9,9,9,9,9,9,9,9,58,108,107],
[107,70,9,9,105,107,108,71,9,9,9,9,9,9,9,56,42,42,42,42,42,42,42,42,42,42,42,42,42,42,42,42,42,42,42,79,9,9,9,9,9,9,9,9,43,109,110,110],
[109,105,9,9,84,106,109,71,9,9,9,9,9,9,9,54,42,42,42,42,42,42,42,42,42,42,42,42,42,42,42,42,42,42,42,79,17,9,10,9,109,59,44,59,111,19,107,85],
[110,70,9,9,9,108,107,106,9,9,9,9,10,9,9,9,34,42,42,42,42,42,42,42,42,42,42,42,42,42,42,42,42,42,42,79,9,17,9,9,95,106,109,107,108,107,70,9],
[111,71,9,9,9,109,97,9,9,9,9,9,12,9,9,9,54,42,42,42,42,42,42,42,42,42,42,42,42,42,42,42,42,42,42,79,17,9,9,9,9,84,107,105,111,110,97,9],
[107,108,45,19,9,18,9,9,9,9,9,9,9,9,14,9,9,91,91,91,91,91,91,91,34,42,42,42,42,42,42,42,42,42,42,79,19,18,9,12,9,9,69,108,109,70,15,13],
[107,109,71,9,17,9,9,9,9,9,9,9,9,9,9,9,9,9,9,10,9,9,9,9,56,42,42,42,42,42,42,42,42,42,46,9,17,9,9,9,9,9,95,110,107,71,9,9],
[106,106,17,9,18,9,9,9,9,9,9,9,9,9,9,9,9,9,9,9,9,9,9,9,56,42,42,42,42,42,42,42,42,27,9,17,18,9,9,9,9,9,9,68,17,70,10,9],
[85,109,70,9,9,17,9,9,9,9,9,9,15,9,9,9,9,9,9,9,9,9,9,9,56,42,42,42,42,42,42,42,46,9,17,18,9,19,9,9,11,9,9,69,108,106,45,16],
[9,95,97,9,19,9,18,19,9,9,10,9,9,9,9,9,9,9,12,9,9,9,10,9,54,42,42,42,42,42,27,91,19,18,9,19,9,9,9,13,9,10,9,68,109,107,110,59],
[9,9,9,9,9,9,19,9,18,106,45,9,9,9,9,9,9,9,9,9,9,9,9,9,9,91,91,34,42,42,79,9,17,9,18,9,9,9,9,14,9,9,9,69,110,111,109,107],
[9,9,9,9,12,9,9,11,9,69,108,59,109,9,9,9,9,9,9,9,9,9,15,9,9,9,9,54,42,46,9,19,9,19,9,9,9,9,15,9,9,9,58,107,108,107,18,108],
[15,9,9,9,9,10,9,9,9,69,107,106,70,9,9,9,9,9,9,9,9,9,13,9,9,9,9,9,55,17,9,18,9,9,9,9,9,17,9,9,9,43,111,106,109,85,96,106],
[9,9,9,9,14,9,13,9,9,95,85,109,110,60,9,9,9,9,9,9,9,9,9,9,10,9,9,9,80,9,9,9,9,9,9,9,9,110,9,9,9,109,96,85,97,9,9,95],
[9,9,9,9,9,9,9,9,9,9,9,84,85,109,9,9,9,9,9,9,9,9,9,20,9,81,92,92,104,9,9,9,9,9,9,9,107,59,109,9,9,9,9,9,9,9,10,9],
[9,9,9,9,9,9,9,9,9,9,19,9,9,9,9,9,9,10,81,92,92,92,21,22,121,104,9,9,9,9,109,59,45,9,9,58,106,108,71,9,9,9,9,9,9,9,9,9],
[9,9,9,9,15,9,9,9,16,9,9,18,9,9,9,13,9,81,104,9,12,9,9,23,9,9,9,109,108,9,69,106,107,60,9,69,107,111,97,9,10,9,9,12,16,9,9,9],
[9,9,9,9,9,9,9,9,9,10,17,9,9,9,9,9,9,80,9,10,9,9,9,9,9,9,9,9,10,9,84,85,108,106,59,106,109,86,9,9,9,9,9,9,9,9,9,9],
[9,9,9,9,9,9,9,9,13,9,43,59,45,9,9,9,9,122,9,9,11,9,43,97,9,9,9,9,9,9,9,9,95,109,107,97,9,9,9,9,9,9,9,9,9,9,9,9],
[9,9,9,9,9,9,9,9,9,58,107,108,109,59,60,10,24,25,26,9,9,58,70,9,9,9,9,14,13,9,9,9,9,84,86,9,9,9,9,9,9,9,9,9,9,14,9,9],
[9,9,9,9,9,9,9,9,43,106,110,105,18,108,106,44,45,123,109,59,59,111,70,9,9,9,16,9,9,9,12,9,9,9,9,11,9,9,9,9,9,9,9,9,9,9,9,9],
[9,9,9,9,9,9,9,58,107,109,111,108,110,111,109,107,71,80,69,109,106,108,106,59,60,9,9,9,9,9,9,9,9,10,9,9,9,9,9,9,9,9,9,9,9,9,9,9]]