[[116,87,112,113,112,115,112,113,116,117,112,113,87,112,113,112,115,112,117,116,113,112,115,113,116,115,116,87,115,112,113,116,112,117,115,113,87,112,113,116,11,9,9,9,9,9,9,9],
[117,116,112,117,116,87,112,113,112,112,116,112,113,115,116,113,116,113,112,115,112,113,112,117,112,113,112,113,116,112,115,112,115,112,112,117,112,117,112,115,110,9,9,9,9,9,9,9],
[112,113,112,116,113,112,115,112,116,115,113,116,114,117,112,117,112,115,116,113,116,116,115,87,116,115,112,115,112,113,117,112,112,115,113,112,113,115,112,11,9,9,9,9,9,9,9,9],
[115,112,115,113,112,113,112,113,112,116,115,112,111,120,110,120,108,108,112,108,117,113,112,113,112,113,115,112,113,115,112,115,113,116,112,117,112,116,113,116,9,9,9,9,9,9,9,9],
[112,113,112,115,112,117,112,115,112,87,112,113,111,9,9,9,9,9,9,9,120,112,116,114,108,112,108,117,114,108,116,112,115,112,113,112,113,116,112,110,9,9,9,9,9,9,9,9],
[115,112,116,113,87,115,116,112,113,112,113,116,112,9,9,9,9,9,9,9,9,109,113,111,9,9,9,120,110,9,9,120,112,114,108,108,108,115,110,9,9,9,9,9,9,9,9,9],
[117,116,113,112,115,113,112,87,116,113,112,114,110,9,9,9,9,9,9,9,9,120,112,116,9,9,9,9,9,9,9,9,109,112,9,9,9,9,9,9,9,9,9,9,9,9,9,119],
[113,112,115,117,116,112,113,112,115,112,116,111,9,9,9,9,9,9,9,9,9,9,131,110,9,9,9,9,9,9,9,9,131,132,9,9,9,9,9,9,9,9,9,9,9,119,70,112],
[112,115,112,116,115,115,113,116,117,113,112,111,9,9,9,9,9,9,9,9,9,9,9,9,9,9,9,9,9,9,9,9,9,9,9,9,9,9,9,9,9,9,9,9,131,87,116,112],
[87,116,113,112,87,112,115,112,112,115,116,118,11,9,9,9,9,9,9,9,9,9,9,9,9,9,9,9,9,9,9,9,9,9,9,9,9,9,9,9,9,9,9,9,132,117,112,116],
[115,112,115,112,115,113,112,113,112,113,112,112,116,9,9,9,9,9,9,9,9,9,9,9,9,9,9,9,9,9,9,9,9,9,9,9,9,9,9,9,9,9,9,9,9,120,117,112],
[117,116,112,118,116,112,113,112,112,117,116,116,115,112,116,11,9,9,119,133,9,9,9,9,9,9,9,9,9,9,9,9,9,9,9,9,9,9,9,9,9,9,9,9,9,9,109,109],
[112,112,116,112,116,115,115,112,113,112,112,118,113,112,115,112,113,70,112,112,131,9,9,9,9,9,9,9,9,9,9,9,9,9,9,9,9,9,9,9,9,9,9,9,9,9,87,115],
[113,112,118,113,112,112,117,116,112,112,116,112,116,113,117,112,116,112,115,118,116,9,9,9,9,9,9,9,9,9,9,9,9,9,9,9,9,9,9,9,9,9,9,9,9,115,116,112],
[112,112,116,112,115,112,113,112,112,113,112,112,117,112,112,113,112,117,113,112,110,9,9,9,9,9,9,9,9,9,9,9,9,9,9,9,9,9,9,9,9,9,9,9,9,120,112,115],
[116,118,112,116,113,116,115,112,118,112,115,112,113,112,116,112,118,116,112,116,9,9,9,9,9,9,9,9,9,9,9,9,9,9,9,9,9,9,9,9,9,9,9,9,9,9,115,118],
[112,112,113,112,115,112,115,113,115,112,117,113,112,113,112,115,113,112,115,131,9,9,9,9,9,9,9,9,9,9,9,9,9,9,9,9,9,9,9,9,9,9,9,9,9,9,112,113],
[113,112,112,117,116,113,112,112,112,113,115,112,108,108,112,108,112,110,9,9,9,9,9,9,9,9,9,9,9,9,9,9,9,9,9,9,9,9,9,9,9,9,9,9,9,9,120,116],
[117,112,115,112,112,115,112,117,115,112,112,110,9,9,9,9,9,9,9,9,9,9,9,9,9,9,9,9,9,9,9,9,9,9,9,9,9,9,9,9,9,9,9,9,9,9,9,113],
[116,113,112,113,117,112,118,112,112,110,9,9,9,9,9,9,9,9,9,9,9,9,9,9,9,9,9,9,9,9,9,9,9,9,9,9,9,9,9,9,9,9,9,9,9,9,9,113],
[112,117,116,112,112,113,112,115,112,111,9,9,9,9,9,9,9,9,9,9,9,9,9,9,9,9,9,9,9,9,9,9,9,9,9,9,9,9,9,9,9,9,9,9,9,9,9,118],
[113,112,112,113,112,115,112,112,113,112,11,9,9,9,9,9,9,9,9,9,9,9,9,9,9,9,9,9,9,9,9,9,9,9,9,9,9,9,9,9,9,9,9,9,9,9,9,112],
[112,116,112,118,112,113,115,113,112,116,111,9,9,9,9,9,9,9,9,9,9,9,9,9,9,9,9,9,9,9,9,9,9,9,9,9,9,9,9,9,9,9,9,9,9,9,9,17],
[118,112,113,112,116,112,112,117,112,117,112,11,9,9,9,9,9,9,9,9,9,9,9,9,9,9,9,9,9,9,9,9,9,9,9,9,9,9,9,9,9,9,9,9,9,9,9,113],
[112,112,112,108,120,112,116,112,116,112,112,111,9,9,9,9,9,9,9,9,9,9,9,9,9,9,9,9,9,9,9,9,9,9,9,9,9,9,9,9,9,9,9,9,9,9,9,118],
[115,113,110,9,9,9,120,112,112,115,116,112,11,9,9,9,9,9,9,9,9,9,9,9,9,9,9,9,9,9,9,9,9,9,9,9,9,9,9,9,9,9,9,9,9,9,9,113],
[112,9,9,9,9,9,9,9,115,112,112,115,112,131,9,9,9,9,9,9,9,9,9,9,9,9,9,9,9,9,9,9,9,9,9,9,9,9,9,9,9,9,9,9,9,9,9,115],
[111,9,9,9,9,9,9,9,9,108,132,110,9,9,9,9,9,9,9,9,9,9,9,9,9,9,9,9,9,9,9,9,9,9,9,9,9,9,9,9,9,9,9,9,9,9,9,116],
[132,9,9,9,9,9,9,9,9,9,9,9,9,9,9,9,9,9,9,9,9,9,9,9,9,9,9,9,9,9,9,9,9,9,9,9,9,9,9,9,9,9,9,9,9,9,9,114],
[131,9,9,9,9,9,9,9,9,9,9,9,9,9,9,9,9,9,9,9,9,9,9,9,9,9,9,9,9,9,9,9,9,9,9,9,9,9,9,9,9,9,9,9,9,9,9,113],
[111,9,9,9,9,9,9,9,9,9,9,9,9,9,9,9,9,9,9,9,9,9,9,9,9,9,9,9,9,9,9,9,9,9,9,9,9,9,9,9,9,9,9,9,9,9,9,112],
[133,9,9,9,9,9,9,9,112,132,9,9,9,9,9,9,13,9,9,9,9,9,9,9,9,9,9,9,9,9,9,9,9,9,9,9,9,9,9,9,9,9,9,9,9,9,9,115],
[112,11,9,9,9,9,9,119,113,133,9,9,9,9,9,9,9,9,9,9,9,9,9,9,9,9,9,9,9,9,9,9,9,9,9,9,9,9,9,9,9,9,9,9,9,9,9,113],
[87,112,11,9,119,112,115,112,112,110,9,9,9,9,9,9,9,9,9,9,9,9,9,9,9,9,9,9,9,9,9,9,9,9,9,9,9,9,9,9,9,9,9,9,9,9,9,118],
[118,116,112,112,115,117,113,115,111,9,9,9,9,9,9,9,9,14,9,9,9,9,9,9,9,9,9,9,9,9,9,9,9,9,9,9,9,9,9,9,9,9,9,9,9,9,9,112],
[112,117,115,116,113,112,120,132,133,9,9,9,9,9,9,9,9,9,9,9,9,9,9,9,9,9,9,9,9,9,9,9,9,9,9,9,9,9,9,9,9,9,9,9,9,9,9,115],
[115,112,113,112,112,110,9,9,9,9,9,9,9,9,9,9,9,9,9,9,9,9,9,9,9,9,9,9,9,9,9,9,9,9,9,9,9,9,9,9,9,9,9,9,9,9,9,113],
[116,112,87,115,116,9,9,9,9,9,9,9,9,9,9,9,9,9,9,9,9,9,9,9,9,9,9,9,9,9,9,9,9,9,9,9,9,9,9,9,9,9,9,9,9,9,9,114],
[117,115,113,112,110,9,9,15,9,9,9,9,9,9,9,9,9,9,9,9,9,9,9,9,9,9,9,9,9,9,9,9,9,9,9,9,9,9,9,9,9,9,9,9,9,9,9,13],
[112,116,112,110,9,9,9,9,9,9,9,9,9,9,9,9,9,9,9,9,9,9,9,9,9,9,9,9,9,9,9,9,9,9,9,9,9,9,9,9,9,9,9,9,9,9,9,113],
[115,113,116,11,9,9,9,9,9,9,9,17,9,9,9,9,9,9,9,9,9,9,9,9,9,9,9,9,9,9,9,9,9,9,9,9,9,9,9,9,9,9,9,9,9,9,9,116],
[112,117,112,112,9,9,9,9,9,9,9,9,9,9,9,9,9,9,9,9,9,9,9,9,9,9,9,9,9,9,9,9,9,9,9,9,9,9,9,9,9,9,9,9,9,9,9,113],
[118,116,115,110,9,9,9,9,9,9,9,9,9,9,9,9,9,9,9,9,9,9,9,9,9,9,9,9,9,9,9,9,9,9,9,9,9,9,9,9,9,9,9,9,9,9,9,115],
[113,112,112,9,9,9,9,9,9,9,9,9,9,9,9,9,9,9,9,9,9,9,9,9,9,9,9,9,9,9,9,9,9,9,9,9,9,9,9,9,9,9,9,9,9,9,9,113],
[112,115,113,11,9,9,9,9,9,9,9,9,116,132,9,9,9,9,9,9,9,9,9,9,9,9,9,9,9,9,9,9,9,9,9,9,9,9,9,9,9,9,9,9,9,9,9,113],
[87,112,116,112,9,9,9,9,9,9,9,109,113,112,11,9,9,9,9,9,9,9,116,115,113,115,112,116,113,9,9,9,116,132,9,9,9,113,9,9,131,9,9,9,9,9,9,116],
[113,117,115,112,11,9,9,9,9,9,119,112,116,113,116,11,9,9,9,9,9,119,115,112,124,113,121,115,116,9,9,9,112,113,9,9,9,115,9,9,113,9,9,9,113,115,112,114],
[112,115,112,113,112,70,112,115,70,112,117,113,112,87,114,118,70,70,115,114,112,113,123,113,116,114,117,113,124,112,117,113,115,116,115,117,113,116,112,116,114,113,115,112,117,112,113,115]]