[[112,112,113,113,113,113,115,9,9,9,9,9,9,9,9,9,9,113,112,113,112,113,112,112,115,116,112,111,45,109,112,115,113,112,116,115,112,113,112,112,111,9,9,9,9,9,9,9],
[112,112,113,112,115,111,9,9,15,9,9,9,9,9,9,9,9,112,132,117,112,113,118,113,112,112,113,111,45,109,113,116,115,113,112,112,113,115,113,116,111,9,9,9,9,9,9,9],
[112,121,122,113,113,112,9,16,14,17,17,17,17,17,17,17,17,131,123,120,112,113,112,112,115,113,112,118,45,109,112,113,113,132,112,115,115,112,116,112,110,9,9,9,9,9,9,9],
[113,41,42,113,113,113,9,9,9,9,9,9,9,9,9,9,9,9,59,18,60,112,115,112,132,112,112,114,45,109,112,113,112,115,113,112,115,118,132,114,9,9,9,9,9,9,9,9],
[113,112,112,115,112,115,113,15,13,9,9,9,9,9,9,9,9,59,34,10,35,60,115,112,113,116,113,111,45,131,117,116,116,112,116,116,113,112,111,9,9,9,9,9,9,9,9,9],
[113,132,113,113,113,113,113,14,59,18,18,18,60,9,9,15,9,58,10,10,10,48,113,115,112,118,112,131,78,55,109,113,115,112,112,112,116,114,110,9,9,9,9,9,9,9,9,9],
[113,112,113,115,113,112,113,118,58,10,10,10,48,9,9,9,9,58,10,10,10,48,113,112,115,115,112,118,132,45,109,112,112,115,113,113,112,111,9,9,9,9,9,9,9,9,9,9],
[113,112,113,115,112,132,113,114,58,10,10,10,48,124,9,9,9,58,10,10,36,61,116,112,112,115,112,112,111,45,109,112,116,116,116,116,113,111,9,9,9,9,9,9,9,9,9,9],
[113,113,113,115,113,113,113,132,58,10,10,10,48,9,9,9,133,58,10,10,48,113,116,115,115,115,115,115,118,45,87,115,112,113,115,118,112,111,9,9,9,9,9,9,9,9,9,9],
[116,118,133,115,16,113,113,118,62,63,33,10,48,9,9,9,131,58,36,63,61,115,132,115,113,112,112,113,133,45,117,112,115,113,117,112,112,118,11,9,9,9,9,9,9,9,9,9],
[113,112,112,115,112,113,132,113,113,11,58,10,48,14,9,9,9,58,48,112,132,116,115,112,115,115,113,112,114,45,109,112,113,115,113,113,113,112,111,9,9,9,9,9,9,9,9,9],
[112,133,115,115,112,113,113,113,113,113,62,63,61,9,9,9,9,62,61,113,116,116,115,113,112,112,131,115,118,45,109,113,116,115,116,112,131,116,131,9,9,9,9,9,9,9,9,9],
[113,116,112,112,113,115,113,115,113,113,116,113,112,133,9,9,9,9,132,116,116,112,112,112,115,112,113,115,114,45,109,113,116,115,112,112,113,116,118,9,9,9,9,9,9,9,9,9],
[115,112,112,116,112,112,113,113,113,115,113,110,9,9,9,9,9,9,120,112,118,116,116,112,116,112,112,112,111,45,109,113,115,131,116,112,115,112,114,9,9,9,9,9,9,9,9,9],
[113,112,113,115,112,116,112,132,113,113,123,9,9,9,9,9,9,9,9,112,116,113,131,112,115,113,118,113,111,45,131,117,115,113,116,113,112,115,111,9,9,9,9,9,9,9,9,9],
[112,115,112,116,113,112,112,108,115,9,9,9,9,9,9,9,9,9,9,116,116,112,112,112,116,112,112,115,118,78,55,109,115,115,112,115,112,115,118,11,9,9,9,9,9,9,9,9],
[108,131,117,113,112,115,9,9,9,9,9,9,9,9,9,9,9,9,9,113,115,113,112,113,112,116,113,115,112,111,45,109,112,116,113,116,112,113,115,111,9,9,9,9,9,9,9,133],
[18,60,120,117,116,112,113,9,9,9,9,9,9,9,9,9,9,9,9,118,113,112,116,118,112,116,116,115,112,118,45,131,117,115,115,112,115,131,113,118,11,9,9,9,15,9,119,116],
[10,35,60,120,108,131,9,9,9,9,9,9,9,9,9,9,9,9,9,115,112,115,116,112,115,115,113,112,112,114,78,55,113,112,116,116,115,115,113,113,111,9,9,9,9,9,113,112],
[10,10,35,18,60,109,113,70,112,113,70,112,9,9,9,9,9,9,9,112,112,115,131,112,112,132,112,116,116,118,11,45,131,116,112,117,113,113,118,116,111,9,9,9,9,9,132,113],
[10,10,10,10,48,117,112,112,115,112,113,112,9,9,9,9,9,9,9,116,115,115,115,112,113,112,115,113,116,112,133,78,55,132,112,112,112,112,131,116,111,9,16,9,9,119,87,115],
[10,10,10,10,35,60,120,117,112,112,113,112,9,9,9,9,9,9,9,112,113,116,115,113,113,113,112,112,116,112,118,133,45,120,117,113,112,112,113,113,110,9,9,9,119,87,113,116],
[10,10,10,10,10,35,60,113,131,116,115,113,115,9,9,9,9,9,112,112,113,118,112,112,118,112,116,112,112,112,114,110,45,9,9,120,117,113,113,114,9,9,9,119,113,115,113,113],
[63,63,33,10,10,10,48,115,112,118,112,112,113,9,9,9,9,9,116,115,115,112,112,113,112,116,116,112,114,112,9,19,20,9,9,9,120,116,110,9,9,9,9,132,112,112,116,112],
[70,11,62,63,33,10,48,115,116,113,113,112,116,9,9,9,9,9,112,112,115,115,112,113,112,112,112,113,110,9,9,22,23,24,9,9,9,9,9,9,9,9,119,113,115,115,112,113],
[112,118,87,11,62,63,61,131,112,115,112,115,113,112,9,9,9,112,113,118,116,116,112,116,113,112,114,110,9,16,9,28,29,9,16,9,9,9,9,9,119,87,113,115,133,112,115,116],
[116,112,131,118,70,87,133,87,115,113,118,112,112,113,9,9,9,113,112,116,112,114,108,108,108,108,110,9,9,9,9,19,20,9,9,9,9,17,9,119,87,113,115,112,112,116,113,113],
[118,113,116,115,112,112,115,112,112,133,112,115,112,112,9,9,9,133,117,114,108,110,9,9,9,9,9,15,9,9,9,22,23,24,9,9,15,9,116,113,112,131,112,112,113,118,113,112],
[112,112,112,113,118,113,112,113,112,113,115,112,116,132,9,9,9,9,132,131,9,9,9,9,9,116,70,87,118,14,9,28,29,9,9,9,9,9,120,117,115,113,112,113,116,115,112,116],
[113,115,112,112,115,116,112,116,115,112,112,113,112,111,9,9,9,9,9,9,9,9,15,9,9,109,112,116,113,111,9,9,78,79,55,9,9,9,9,109,113,115,112,116,113,116,114,108],
[117,114,108,117,112,112,114,108,133,112,116,113,115,112,118,9,9,9,9,16,9,9,9,9,9,117,115,112,115,111,9,9,131,132,78,79,79,55,119,87,113,112,115,113,115,112,110,59],
[9,9,9,120,133,108,110,9,120,108,108,117,113,113,131,9,9,9,15,9,9,9,9,9,9,131,108,108,114,133,9,9,116,117,118,70,11,45,120,117,112,118,116,113,112,111,59,34],
[9,9,9,9,9,9,9,9,9,9,9,109,112,116,112,118,9,9,9,9,9,16,9,9,9,15,9,9,116,9,9,9,9,123,108,108,118,78,55,120,117,115,113,112,114,110,58,10],
[9,9,9,9,9,9,9,9,9,9,9,120,117,115,112,111,9,9,9,9,9,9,9,9,9,9,9,9,9,14,9,9,9,9,9,9,117,118,78,55,109,113,115,114,110,59,34,10],
[9,9,9,9,9,9,9,9,9,9,9,9,120,117,112,118,15,9,15,9,9,9,124,118,70,70,11,9,9,9,9,9,9,9,9,21,132,108,133,45,109,115,114,110,59,34,10,10],
[9,9,9,9,9,9,9,9,9,9,9,9,9,113,108,123,16,15,16,15,133,87,113,112,115,112,118,87,131,9,9,21,9,43,25,26,27,56,56,71,132,116,111,59,34,10,10,10],
[9,9,9,9,9,9,9,9,9,9,9,9,9,9,9,9,9,16,9,15,109,113,115,112,113,118,113,115,133,43,25,26,27,71,30,31,116,70,70,70,87,113,111,58,10,10,10,10],
[9,9,9,9,9,9,9,9,9,9,9,9,9,9,9,9,9,9,9,116,87,116,114,108,108,117,112,111,43,71,30,31,32,132,9,9,120,117,113,113,116,112,111,62,33,10,10,10],
[9,9,9,9,9,9,9,9,9,9,9,9,9,9,9,9,9,9,9,132,108,108,110,9,9,120,116,132,44,133,116,9,9,9,131,9,9,109,115,115,113,112,118,11,58,10,10,10],
[9,9,9,9,9,9,9,9,9,9,9,9,9,9,9,9,9,9,9,9,9,9,9,9,9,9,133,43,71,109,118,9,9,9,9,9,9,133,112,112,115,118,112,132,58,10,10,10],
[9,9,9,9,9,9,9,9,9,9,9,9,9,9,9,9,9,9,9,9,9,9,9,9,9,9,19,20,132,87,113,113,9,9,9,9,9,120,117,112,118,112,113,111,62,33,10,10],
[9,9,9,9,9,9,9,9,9,9,9,9,9,9,9,9,9,9,9,9,9,9,9,9,9,9,22,23,24,9,117,112,131,9,9,14,9,9,109,116,116,113,112,118,11,58,10,10],
[9,9,9,9,9,9,9,9,9,9,9,9,9,9,9,9,9,9,9,9,9,9,9,9,9,9,28,29,9,9,9,117,133,9,9,9,9,9,109,113,113,115,116,113,131,58,10,10],
[9,9,9,9,9,9,9,9,9,9,9,9,9,9,9,9,9,9,9,9,9,9,9,9,9,9,43,71,9,9,9,9,9,15,9,9,9,9,109,115,115,112,112,112,114,58,10,10],
[70,87,118,70,11,9,9,9,9,9,119,70,11,9,9,9,9,9,9,9,9,9,9,9,9,19,20,9,9,9,17,9,9,9,9,15,9,87,116,112,112,113,116,113,111,58,10,10],
[115,113,112,115,118,70,70,132,70,87,112,113,111,9,9,9,9,9,9,9,9,9,9,9,9,22,23,24,9,14,9,9,9,9,16,9,119,113,113,116,113,112,112,132,110,58,10,10],
[113,116,113,112,116,115,112,116,112,112,115,116,118,70,70,70,70,87,118,70,70,70,70,70,70,11,29,9,9,9,119,118,87,11,9,119,87,131,115,112,115,116,114,110,59,34,10,10],
[112,115,112,116,113,112,113,112,115,113,112,113,112,112,116,113,115,116,112,113,132,112,113,133,112,111,44,119,70,70,87,112,113,118,87,116,112,113,116,112,113,112,111,59,34,10,10,10]]