[[9,9,9,9,9,9,9,9,9,9,9,9,9,9,9,9,9,9,9,9,9,9,9,9,9,9,9,9,9,87,115,112,113,116,115,112,78,55,116,113,118,9,9,9,9,9,9,9],
[132,9,9,9,9,9,9,9,9,9,9,9,9,9,9,9,9,9,9,9,9,9,9,9,9,9,9,9,9,114,9,113,124,112,9,9,113,78,55,123,115,17,9,9,9,9,9,9],
[116,9,9,9,9,9,9,9,9,9,9,9,9,9,9,9,9,9,9,9,9,9,9,9,9,9,9,9,9,9,9,118,9,115,112,9,115,19,20,9,9,9,9,9,9,9,9,9],
[115,132,9,9,9,9,9,9,9,9,9,9,9,9,9,9,9,9,9,9,9,9,9,9,9,9,9,9,9,9,9,9,9,9,14,9,9,22,23,24,9,9,9,9,9,9,9,9],
[112,133,9,9,9,9,9,9,9,9,9,9,9,9,9,9,9,9,9,9,9,9,9,9,9,9,9,9,9,9,9,9,9,9,9,9,9,28,29,124,13,9,9,9,9,9,9,9],
[113,110,9,9,9,9,9,9,9,9,9,9,9,9,9,9,9,9,9,9,9,9,9,9,9,9,9,9,9,9,9,9,9,9,9,9,9,9,78,55,113,131,9,9,9,9,9,9],
[111,9,9,9,9,9,9,9,9,9,9,9,9,9,9,9,9,9,9,9,9,9,9,9,9,9,9,9,9,9,9,9,9,9,9,9,9,133,113,73,116,113,118,9,9,9,9,9],
[118,70,116,70,132,9,9,9,9,9,9,9,9,9,9,9,9,9,9,9,9,9,9,9,9,9,9,9,9,9,9,9,9,9,9,9,9,115,112,78,55,115,132,9,9,9,9,119],
[116,115,103,116,116,9,9,9,9,9,9,9,9,9,9,9,9,9,9,9,9,9,9,9,9,9,9,9,9,9,9,9,9,9,9,9,9,131,109,116,78,79,56,55,9,133,112,87],
[115,106,113,115,111,9,9,9,9,9,9,9,9,9,9,9,9,9,9,9,9,9,9,9,9,9,9,9,9,9,9,9,9,9,9,9,9,9,9,120,15,9,9,73,113,112,113,116],
[111,116,113,114,9,9,9,9,9,9,9,9,9,9,9,9,9,9,9,9,9,9,9,9,9,9,9,9,9,9,9,9,9,9,9,9,9,9,9,9,9,9,43,71,116,113,122,117],
[112,112,116,9,9,9,9,9,9,9,9,9,9,9,9,9,9,9,9,9,9,9,9,9,9,9,9,9,9,9,9,9,9,9,9,9,9,131,70,113,116,115,78,57,55,115,113,112],
[114,113,9,9,9,9,9,9,9,9,9,9,9,9,9,9,9,9,9,9,9,9,9,9,9,9,9,9,9,9,9,9,9,9,9,9,112,113,125,102,113,112,113,116,72,116,104,112],
[113,110,112,9,9,9,9,9,9,9,9,9,9,9,9,9,9,9,9,9,9,9,9,9,9,9,9,9,9,9,9,9,9,9,9,9,133,115,104,105,115,124,112,43,71,113,112,87],
[87,11,9,9,9,9,9,9,9,9,9,9,9,9,9,9,9,9,9,9,9,9,9,9,9,9,9,9,9,9,9,9,9,9,9,9,9,132,108,116,112,113,116,12,116,115,115,113],
[119,116,9,9,9,9,9,9,9,9,9,9,9,9,9,9,9,9,9,9,9,9,9,9,9,9,9,9,9,9,9,9,9,9,9,9,9,9,9,120,116,112,59,46,18,18,60,115],
[112,114,9,9,9,9,9,9,9,9,9,9,9,9,9,9,9,9,9,9,9,9,9,9,9,9,9,9,9,9,9,9,9,9,9,9,9,9,9,9,120,113,58,10,10,10,35,60],
[115,112,9,9,9,9,9,9,9,9,9,9,9,9,9,9,9,9,9,9,9,9,9,9,9,9,9,9,9,9,9,9,9,9,9,9,9,9,9,9,59,18,34,10,10,10,10,10],
[55,113,117,9,9,9,9,9,9,9,9,9,9,9,9,9,9,9,9,9,9,9,9,9,9,9,9,9,9,9,9,9,9,9,9,9,9,9,9,16,62,33,10,10,10,10,10,10],
[72,115,9,9,15,9,9,9,17,112,9,9,9,9,9,9,9,9,9,9,9,9,9,9,9,9,9,9,9,9,9,9,9,9,9,9,9,15,112,116,115,58,10,10,10,10,36,63],
[45,113,133,9,114,9,116,9,113,115,112,115,9,131,9,9,9,132,9,9,9,9,9,9,9,9,9,9,9,9,9,9,9,9,9,9,9,9,87,113,9,62,63,33,10,10,48,116],
[72,116,115,21,115,112,113,9,43,56,79,55,9,114,116,14,9,115,13,11,133,9,9,9,9,9,9,9,9,9,9,9,9,9,9,9,9,9,115,112,113,115,123,58,10,10,48,113],
[78,57,25,26,27,55,123,43,71,113,115,44,115,112,113,112,59,18,60,115,112,131,9,9,9,9,9,9,9,9,9,9,9,9,9,9,9,9,131,112,43,56,76,77,36,63,61,115],
[115,115,30,31,32,78,56,71,115,117,113,78,57,79,55,115,58,10,35,60,113,11,9,9,9,9,9,9,70,9,9,9,9,9,9,9,9,113,112,115,44,126,103,82,48,116,113,112],
[115,116,115,9,9,113,16,113,116,87,118,115,116,115,78,76,77,10,10,48,115,116,9,9,9,9,132,113,115,113,131,9,9,9,21,87,115,112,113,43,71,106,107,62,61,109,87,116],
[113,112,110,9,9,116,9,112,109,114,116,110,110,117,116,9,82,10,36,61,112,111,9,9,9,9,9,116,103,116,118,14,43,25,26,27,79,57,80,71,113,116,112,110,9,112,103,114],
[113,116,113,9,9,108,9,9,132,131,9,9,9,9,9,9,62,33,48,115,113,113,9,9,133,9,116,112,113,115,43,57,71,30,31,32,117,115,112,115,116,112,116,9,9,108,117,115],
[116,112,11,9,9,9,9,9,9,9,9,9,9,9,14,117,116,58,74,75,56,55,9,113,116,115,126,116,115,43,71,131,9,9,9,9,9,116,113,110,9,133,9,9,9,9,109,113],
[115,113,118,70,131,9,9,9,9,9,9,9,9,9,9,87,115,58,81,116,115,78,79,57,55,116,115,107,112,12,132,116,9,9,13,17,9,9,9,9,9,9,9,9,9,9,132,116],
[112,116,115,112,111,9,9,9,9,9,9,9,9,9,9,9,113,62,35,60,113,112,125,115,44,113,112,115,115,46,47,60,9,9,9,9,9,9,9,9,9,9,9,9,9,9,9,110],
[115,113,66,113,118,132,9,9,9,9,9,9,9,9,9,9,115,116,62,61,115,125,102,113,73,113,116,59,34,10,10,48,121,122,132,131,9,9,9,9,9,9,9,9,9,9,9,9],
[116,112,115,112,114,110,9,9,9,9,9,9,9,9,9,9,9,9,9,116,113,104,105,116,78,79,76,77,10,10,10,48,41,42,113,111,119,70,132,9,9,9,9,9,9,9,9,9],
[113,125,113,116,118,70,70,132,9,9,9,9,9,9,9,9,9,9,9,9,132,116,114,9,9,115,115,82,10,10,10,35,60,116,112,118,87,113,11,9,9,9,9,9,9,9,9,9],
[115,116,105,113,115,40,115,113,9,9,9,131,115,132,9,9,9,9,9,70,9,9,9,9,87,111,116,62,33,10,10,36,61,115,113,112,113,116,111,9,9,16,9,9,9,9,9,9],
[116,112,113,112,114,117,114,116,9,9,9,116,124,116,9,9,9,9,109,112,118,70,87,116,113,118,11,115,62,33,36,61,116,113,115,59,18,18,18,60,113,112,116,115,131,9,9,9],
[113,116,115,113,111,120,133,9,9,9,9,59,18,60,112,9,9,9,116,117,116,113,121,122,115,113,118,113,59,34,35,18,60,59,18,34,10,10,10,48,116,87,114,113,115,119,113,119],
[115,112,113,116,111,9,9,9,123,132,59,34,10,35,60,9,9,9,9,131,108,117,41,42,114,124,108,116,58,10,10,10,35,34,10,10,10,10,10,48,115,112,113,122,112,113,116,87],
[113,116,113,114,110,9,43,80,56,76,77,10,10,10,48,112,9,9,9,9,9,116,112,113,118,70,11,113,58,10,36,63,33,10,10,10,10,10,10,35,60,116,112,115,116,112,113,115],
[116,115,108,110,9,9,73,115,113,116,82,10,36,63,61,116,132,9,9,9,9,109,113,116,131,9,9,9,62,89,61,124,58,10,10,10,10,10,10,10,35,18,18,60,113,115,123,113],
[114,9,9,9,9,43,71,116,104,113,58,10,74,75,79,57,55,9,112,132,9,9,115,132,9,9,113,112,116,88,116,113,62,33,10,10,10,10,10,10,10,10,10,48,115,112,113,87],
[9,9,9,9,43,71,113,110,9,9,62,33,81,116,113,116,72,115,113,116,11,9,9,9,9,111,115,123,113,73,115,112,113,62,33,10,10,10,10,10,10,10,36,61,116,42,116,115],
[9,9,9,9,73,9,9,9,9,119,116,62,61,112,65,115,78,80,56,55,113,112,70,113,120,113,112,113,115,78,56,55,115,123,58,10,10,10,10,10,10,10,48,124,115,117,112,87],
[9,9,9,9,45,9,112,113,112,90,112,113,115,113,116,118,112,115,123,73,115,116,112,124,112,115,112,103,116,113,116,73,113,115,58,10,10,10,10,10,10,10,35,18,60,116,106,116],
[9,9,9,9,44,113,126,117,113,116,115,114,116,112,124,115,113,111,116,78,56,55,115,112,113,106,113,116,113,115,43,71,116,113,58,10,10,10,10,10,36,63,63,63,61,115,113,113],
[9,9,9,133,72,115,113,112,115,113,112,116,113,87,116,105,115,118,112,115,116,78,55,116,115,116,115,43,56,80,71,115,112,70,58,10,10,10,10,10,48,112,113,115,118,113,115,112],
[43,79,57,57,71,112,87,112,116,115,122,113,115,115,113,116,113,112,66,118,113,112,78,80,79,80,56,71,116,115,109,118,87,113,62,33,10,10,10,10,35,18,60,116,112,118,87,113],
[71,115,116,115,126,116,113,116,113,113,115,112,116,112,115,113,115,113,112,116,118,124,113,116,115,116,113,112,70,112,87,104,115,116,112,58,10,10,10,10,10,10,35,60,113,41,113,112],
[116,114,113,112,117,112,116,117,115,112,114,113,113,117,115,112,114,113,42,115,117,113,115,118,70,112,70,87,113,115,116,116,112,115,116,62,63,33,10,10,10,10,10,48,116,112,113,116]]