[[11,9,9,9,9,16,9,9,9,13,9,9,9,9,9,9,14,9,9,9,9,10,108,109,110,106,110,107,9,9,9,9,11,9,9,14,9,9,9,9,15,84,109,106,107,108,110,106],
[9,9,9,9,9,9,9,9,9,9,16,9,9,9,9,9,9,9,9,9,13,9,12,108,107,109,110,9,9,14,9,9,9,9,9,9,9,12,9,9,9,16,9,12,11,109,109,109],
[9,9,14,9,9,14,9,9,9,9,15,9,9,9,13,9,15,9,9,9,9,111,110,86,10,9,106,110,18,9,9,15,9,9,9,9,9,9,10,9,9,9,9,9,16,14,95,109],
[9,9,9,9,9,9,9,11,9,16,9,9,9,9,9,9,9,9,9,12,17,97,9,9,9,14,9,9,11,9,9,9,16,109,44,9,15,9,9,9,9,9,9,9,9,9,10,108],
[9,11,9,9,13,9,12,9,44,109,9,9,11,9,9,9,9,9,9,9,9,11,9,9,9,9,9,13,9,9,12,9,9,14,111,110,109,9,9,13,9,9,9,12,9,13,9,68],
[9,9,10,107,58,110,9,10,111,70,12,109,45,9,9,9,9,9,9,14,9,9,20,9,9,20,12,9,9,9,9,9,9,10,108,69,107,16,108,110,9,16,9,9,9,9,68,107],
[9,9,105,12,111,109,45,58,95,109,43,110,107,109,9,9,14,9,81,92,92,21,22,121,21,22,121,92,92,93,9,9,15,9,95,109,13,14,95,109,60,9,9,9,9,9,108,109],
[9,9,16,9,14,109,107,111,110,109,110,109,109,110,10,16,9,9,100,15,10,11,23,9,14,23,9,13,12,100,9,9,9,9,9,111,111,107,11,69,107,10,9,9,9,15,9,107],
[14,9,9,9,10,84,109,69,108,110,111,107,97,11,12,9,9,15,100,9,13,16,20,9,9,20,11,9,9,100,13,9,9,9,15,12,109,84,107,109,97,45,14,9,9,9,9,11],
[9,13,9,108,59,59,111,109,106,81,92,92,92,92,92,92,92,92,104,9,81,21,22,121,21,22,121,93,10,101,92,92,92,92,92,92,92,92,93,108,107,111,110,15,9,9,16,9],
[9,9,9,109,85,43,107,110,109,100,11,12,16,15,10,16,13,9,11,12,100,9,23,9,9,23,9,100,15,9,12,14,9,13,16,11,15,10,100,43,43,109,13,9,9,9,9,9],
[10,9,9,9,11,111,109,109,110,100,13,81,92,92,92,92,92,92,92,92,104,9,9,9,9,9,9,101,92,92,92,92,92,92,92,92,93,13,100,108,86,108,9,9,9,9,9,10],
[9,9,9,9,9,107,109,96,107,100,10,100,9,9,9,9,9,9,9,9,9,9,9,9,9,9,9,9,9,9,9,9,9,9,9,9,100,16,100,110,60,11,9,9,9,9,9,9],
[9,9,16,9,107,109,9,9,9,100,9,100,9,9,9,9,9,9,9,9,9,9,9,9,9,9,9,9,9,9,9,9,9,9,9,9,100,12,100,109,111,9,9,9,12,9,16,9],
[9,9,9,9,109,106,9,19,11,100,15,100,9,9,9,9,9,9,9,9,9,9,9,9,9,9,9,9,9,9,9,9,9,9,9,9,100,9,100,12,9,9,12,9,9,18,9,9],
[9,11,9,9,9,11,10,9,9,100,9,100,9,9,9,9,9,9,9,9,9,9,9,9,9,9,9,9,9,9,9,9,9,9,9,9,100,10,100,9,9,13,9,9,9,11,9,9],
[9,9,9,9,9,9,13,9,10,100,14,100,9,9,9,9,9,9,9,9,9,9,9,9,9,9,9,9,9,9,9,9,9,9,9,9,100,11,100,10,9,16,9,9,9,9,15,9],
[9,9,13,9,9,9,81,92,92,104,16,100,9,9,9,9,9,9,9,9,9,9,9,9,9,9,9,9,9,9,9,9,9,9,9,9,100,15,101,92,92,93,9,15,9,9,9,11],
[15,9,9,10,109,10,100,14,9,13,12,100,9,9,9,9,9,9,9,9,9,9,9,9,9,9,9,9,9,9,9,9,9,9,9,9,100,13,14,15,10,100,9,9,9,9,13,109],
[9,105,44,111,86,9,100,9,11,81,92,104,9,9,9,9,9,9,9,9,9,9,9,9,9,9,9,9,9,9,9,9,9,9,9,9,101,92,93,9,12,100,11,9,9,14,9,68],
[9,11,107,86,9,9,100,9,9,100,9,9,9,9,9,9,9,9,9,9,9,9,9,9,9,9,9,9,9,9,9,9,9,9,9,9,9,9,100,11,9,100,9,9,9,9,10,68],
[9,9,109,110,12,9,122,10,16,122,9,9,9,9,9,9,9,9,9,9,9,9,9,9,9,9,9,9,9,9,9,9,9,9,9,9,9,9,122,9,13,122,10,9,13,9,9,95],
[9,9,13,9,9,24,25,26,24,25,26,9,9,9,9,9,9,9,9,9,9,9,9,9,9,9,9,9,9,9,9,9,9,9,9,9,9,24,25,26,24,25,26,9,9,15,9,13],
[9,9,9,9,9,9,123,14,9,123,9,9,9,9,9,9,9,9,9,9,9,9,9,9,9,9,9,9,9,9,9,9,9,9,9,9,9,9,123,9,12,123,9,9,9,9,9,9],
[9,9,9,9,9,9,122,9,16,122,9,9,9,9,9,9,9,9,9,9,9,9,9,9,9,9,9,9,9,9,9,9,9,9,9,9,9,9,122,14,16,122,9,11,9,9,12,9],
[9,11,9,9,9,24,25,26,24,25,26,9,9,9,9,9,9,9,9,9,9,9,9,9,9,9,9,9,9,9,9,9,9,9,9,9,9,24,25,26,24,25,26,9,9,9,9,9],
[15,9,9,9,10,9,123,15,9,123,9,9,9,9,9,9,9,9,9,9,9,9,9,9,9,9,9,9,9,9,9,9,9,9,9,9,9,9,123,13,9,123,9,14,9,12,9,9],
[9,13,9,9,9,9,100,9,14,100,9,9,9,9,9,9,9,9,9,9,9,9,9,9,9,9,9,9,9,9,9,9,9,9,9,9,9,9,100,9,10,100,12,9,17,9,9,11],
[9,9,9,12,9,9,100,9,9,101,92,93,9,9,9,9,9,9,9,9,9,9,9,9,9,9,9,9,9,9,9,9,9,9,9,9,81,92,104,11,9,100,9,9,11,15,9,9],
[10,9,9,9,9,9,100,13,9,15,14,100,9,9,9,9,9,9,9,9,9,9,9,9,9,9,9,9,9,9,9,9,9,9,9,9,100,12,11,9,12,100,9,9,9,9,9,10],
[9,9,9,13,9,11,101,92,92,93,10,100,9,9,9,9,9,9,9,9,9,9,9,9,9,9,9,9,9,9,9,9,9,9,9,9,100,13,81,92,92,104,9,11,9,9,9,9],
[9,9,15,9,9,9,9,9,9,100,9,100,9,9,9,9,9,9,9,9,9,9,9,9,9,9,9,9,9,9,9,9,9,9,9,9,100,14,100,13,9,10,9,9,9,9,9,9],
[11,9,9,9,9,15,9,9,9,100,11,100,9,9,9,9,9,9,9,9,9,9,9,9,9,9,9,9,9,9,9,9,9,9,9,9,100,10,100,9,9,9,9,9,9,9,12,9],
[9,9,12,9,16,9,9,9,9,100,9,100,9,9,9,9,9,9,9,9,9,9,9,9,9,9,9,9,9,9,9,9,9,9,9,9,100,9,100,9,9,9,16,9,14,9,9,9],
[9,9,9,9,9,9,15,9,9,100,12,100,9,9,9,9,9,9,9,9,9,9,9,9,9,9,9,9,9,9,9,9,9,9,9,9,100,9,100,9,9,9,9,9,9,9,9,9],
[9,9,16,9,9,9,9,14,9,100,9,100,9,9,9,9,9,9,9,9,9,9,9,9,9,9,9,9,9,9,9,9,9,9,9,9,100,15,100,9,19,12,9,9,9,9,9,11],
[9,11,9,13,9,10,111,109,11,100,15,101,92,92,92,92,92,92,92,92,93,9,9,9,9,9,9,81,92,92,92,92,92,92,92,92,104,9,100,111,11,9,9,9,9,9,9,9],
[9,9,15,14,9,12,109,110,110,100,13,9,10,9,13,9,11,14,15,12,100,9,20,9,9,20,9,100,15,10,14,13,9,12,15,11,9,14,100,111,108,9,109,9,9,10,9,9],
[13,9,9,9,111,110,107,108,108,101,92,92,92,92,92,92,92,92,93,14,101,21,22,121,21,22,121,104,12,81,92,92,92,92,92,92,92,92,104,13,110,45,14,9,9,9,9,15],
[9,14,9,9,10,110,108,109,106,107,109,12,9,9,12,9,10,9,100,9,13,10,23,9,9,23,9,16,9,100,16,9,9,9,9,10,12,107,106,108,107,108,12,111,9,9,9,9],
[15,9,9,16,9,11,110,110,107,108,60,10,13,16,9,9,9,9,100,16,9,9,20,12,9,20,15,9,10,100,9,9,9,9,9,9,111,109,95,107,69,108,109,110,9,9,12,9],
[9,12,9,9,12,110,109,69,109,107,109,45,12,9,9,15,9,9,101,92,92,21,22,121,21,22,121,92,92,104,9,14,9,9,9,11,13,13,109,108,107,110,70,13,9,9,9,9],
[9,9,9,9,9,14,10,107,108,110,109,110,108,11,9,9,12,9,9,9,11,9,23,9,9,23,9,9,9,12,9,9,106,16,9,9,9,111,97,11,68,109,110,9,9,9,9,9],
[11,9,9,15,9,9,9,11,110,97,95,96,109,11,9,9,9,9,10,9,9,9,9,11,9,9,10,9,9,9,9,15,9,9,9,9,9,9,16,12,110,108,11,111,9,11,9,9],
[9,9,9,9,9,13,9,9,12,10,9,13,10,9,15,9,9,110,9,9,13,9,9,9,9,9,9,15,9,9,9,9,9,12,9,9,9,15,9,109,86,12,9,9,9,9,9,11],
[9,9,9,15,9,9,9,11,9,15,9,9,9,14,9,9,14,11,9,9,9,9,9,9,12,11,9,9,11,9,13,9,9,9,9,13,9,9,9,13,9,9,9,9,16,9,9,9],
[13,10,9,9,9,9,9,9,9,9,12,9,9,16,9,9,9,9,15,9,9,9,15,9,108,13,9,9,9,9,9,9,9,9,9,9,9,9,9,9,9,9,9,9,9,9,14,9],
[9,9,14,9,11,9,9,9,12,9,9,15,9,9,9,13,9,9,9,9,9,16,9,9,14,9,9,14,9,9,9,11,9,9,9,9,10,9,9,9,9,9,9,10,9,9,9,12]]