[[10,10,10,10,10,10,10,10,10,10,10,10,10,10,10,10,10,10,10,10,10,10,10,10,10,10,10,10,10,10,10,10,10,10,10,10,10,10,10,10,10,10,10,10,10,10,10,10],
[10,10,10,10,10,10,10,10,10,10,10,10,10,10,10,10,10,10,10,10,10,10,10,10,10,10,10,10,10,10,10,10,10,10,10,10,10,10,10,10,10,10,10,10,10,10,10,10],
[10,10,10,10,10,10,10,10,10,10,10,10,10,10,10,10,10,10,10,10,10,10,10,10,10,10,10,10,10,10,10,10,10,10,10,10,10,10,10,10,10,10,10,10,10,10,10,10],
[10,10,10,10,10,10,10,10,10,10,10,10,10,10,10,10,10,10,10,10,10,10,10,10,10,10,10,10,10,10,10,10,10,10,10,10,10,10,10,10,10,10,10,10,10,10,10,10],
[10,10,10,10,10,10,10,10,10,10,10,10,10,10,10,10,10,10,36,63,63,63,63,63,63,63,63,63,63,63,63,33,10,10,10,10,10,10,10,10,10,10,10,10,10,10,10,10],
[10,10,10,10,10,10,10,10,10,10,10,10,10,10,10,36,63,63,61,119,70,70,87,118,70,132,70,87,118,112,11,62,63,63,63,33,10,10,10,10,10,10,10,10,10,10,10,10],
[10,10,10,10,10,10,10,10,10,10,10,10,10,10,36,61,114,117,114,108,133,132,110,108,117,114,108,117,112,112,118,133,112,112,11,62,63,33,10,10,10,10,10,10,10,10,10,10],
[10,10,10,10,10,10,10,10,10,10,10,10,36,63,61,112,111,9,9,9,9,9,9,9,9,9,9,120,113,112,115,112,131,113,118,70,131,62,33,10,10,10,10,10,10,10,10,10],
[10,10,10,10,10,10,10,10,10,10,10,36,61,113,112,113,132,9,9,9,9,9,9,9,9,9,9,9,131,112,112,112,112,115,113,112,118,11,62,63,33,10,10,10,10,10,10,10],
[10,10,10,10,10,10,10,10,10,10,36,61,132,115,114,110,9,9,9,9,9,9,9,9,9,9,9,9,117,112,113,133,113,115,112,115,112,118,70,133,62,33,10,10,10,10,10,10],
[10,10,10,10,10,10,10,10,10,36,61,112,113,112,110,9,9,9,9,9,9,9,9,9,9,9,9,9,120,112,115,112,115,112,131,112,112,116,112,112,118,62,33,10,10,10,10,10],
[10,10,10,10,10,10,10,10,36,61,113,113,112,110,9,9,9,9,9,9,9,9,9,9,9,9,9,9,9,132,117,113,112,116,112,113,112,113,112,113,112,11,58,10,10,10,10,10],
[63,63,33,10,10,10,36,63,61,119,112,116,111,9,9,9,9,9,9,9,9,9,9,9,9,9,9,9,9,9,120,133,108,108,108,117,114,133,108,117,112,118,58,10,10,10,10,10],
[9,9,62,63,63,63,61,119,87,112,113,114,132,9,9,9,9,9,9,9,9,9,9,9,9,9,9,9,9,9,9,9,9,9,9,9,9,9,9,109,116,114,58,10,10,10,10,10],
[9,9,9,9,9,9,119,115,113,113,112,110,9,9,9,9,9,9,9,9,9,9,9,9,9,9,9,9,9,9,9,9,9,9,9,9,9,9,9,120,112,111,58,10,10,10,10,10],
[9,9,9,9,9,9,133,112,115,115,114,9,9,9,9,9,9,9,9,9,9,9,9,9,9,9,9,9,9,9,9,9,9,9,9,9,9,9,9,9,116,111,58,10,10,10,10,10],
[9,9,9,9,9,9,113,113,112,108,9,9,9,9,9,9,9,9,9,9,9,9,9,9,9,9,9,9,9,9,9,9,9,9,9,9,9,9,9,9,132,131,58,10,10,10,10,10],
[9,9,9,9,9,9,120,112,114,9,9,9,9,9,9,9,9,9,9,9,9,9,9,9,9,9,9,9,9,9,9,9,9,9,9,9,9,9,9,9,9,9,58,10,10,10,10,10],
[70,70,70,131,9,9,9,132,110,9,9,9,9,9,9,9,9,9,9,9,9,9,9,9,9,9,9,9,9,9,9,9,9,9,9,9,9,9,9,9,9,9,62,33,10,10,10,10],
[112,115,113,118,9,9,9,9,9,9,9,9,9,9,9,9,9,9,9,9,9,9,9,9,9,9,9,9,9,9,9,9,9,9,9,9,9,9,9,9,9,9,9,58,10,10,10,10],
[112,113,112,112,118,9,9,9,9,9,9,9,9,9,9,9,9,9,9,9,9,9,9,9,9,9,9,9,9,9,9,9,9,9,9,9,9,9,9,9,9,9,9,62,33,10,10,10],
[115,112,113,116,115,11,132,9,9,9,9,9,9,9,9,9,9,9,9,9,9,9,9,9,9,9,9,9,9,9,9,9,9,9,9,9,9,9,9,9,9,9,9,9,58,10,10,10],
[112,115,128,85,86,116,118,9,9,9,9,9,9,112,113,112,115,9,9,9,9,9,9,9,9,9,9,9,9,9,9,9,9,9,9,9,9,9,9,9,9,9,9,9,62,33,10,10],
[113,112,93,94,95,115,112,11,9,9,9,9,9,87,116,113,116,9,9,9,9,9,9,9,9,9,9,9,9,9,9,9,9,132,9,9,9,9,9,9,9,9,9,9,9,58,10,10],
[112,113,99,100,101,113,112,131,9,9,9,87,114,108,115,112,113,9,9,9,9,9,9,9,9,9,9,9,9,9,9,112,113,118,11,9,9,9,9,9,9,9,9,9,9,58,10,10],
[112,115,116,115,114,108,112,9,9,9,9,133,110,9,9,117,132,9,9,9,9,9,9,9,9,9,9,9,9,9,9,87,114,108,110,9,9,9,9,9,9,9,9,9,9,58,10,10],
[112,112,112,108,112,9,9,9,9,9,9,9,9,9,9,9,9,9,9,9,9,9,9,9,9,9,9,9,9,9,109,114,110,9,9,9,9,9,9,9,9,9,9,9,9,58,10,10],
[112,108,114,9,9,9,9,9,9,9,9,9,9,9,9,9,9,9,9,9,9,9,9,9,9,9,9,9,9,9,133,131,9,9,9,9,9,9,9,9,9,9,9,9,9,58,10,10],
[114,9,9,9,9,9,9,9,9,9,9,9,15,9,9,9,9,9,9,9,9,9,9,9,9,9,9,9,9,9,9,9,9,9,9,9,9,9,9,9,9,119,87,118,131,62,33,10],
[131,9,9,9,9,9,9,9,9,9,9,9,9,9,9,9,9,9,9,9,9,9,119,70,132,9,9,9,9,9,9,9,9,9,9,9,9,9,9,9,87,114,108,108,117,132,58,10],
[9,9,9,9,9,9,9,9,9,9,9,16,9,9,9,133,70,70,87,118,70,87,112,115,114,9,9,9,9,9,9,9,9,9,9,9,9,9,9,112,115,110,9,9,9,9,58,10],
[9,9,9,9,9,9,119,113,116,9,9,9,9,9,9,109,112,116,113,115,133,113,112,113,111,11,9,9,9,9,9,126,103,9,9,9,9,9,119,113,110,9,9,9,9,9,58,10],
[9,9,9,21,9,131,117,112,115,111,9,9,9,9,9,120,117,113,131,116,112,116,115,112,114,133,9,9,9,9,9,106,107,9,9,9,9,9,131,132,9,9,9,9,9,9,58,10],
[80,80,25,26,27,80,55,114,108,117,9,9,9,9,9,9,131,112,115,115,113,114,108,108,132,9,9,9,9,9,9,9,9,9,9,9,9,9,9,9,9,9,9,9,9,9,58,10],
[112,115,30,31,32,9,78,80,55,133,9,9,9,9,9,9,120,115,113,114,110,9,9,9,9,9,9,9,9,9,9,9,9,9,9,9,9,9,9,9,9,9,131,112,113,11,58,10],
[113,116,118,9,9,9,9,9,78,55,9,9,9,9,9,9,9,120,108,131,9,9,9,9,9,9,9,9,9,9,9,9,9,9,9,9,9,9,9,9,9,9,9,113,117,111,58,10],
[114,108,131,9,9,9,9,9,9,45,9,9,9,9,9,9,9,9,9,9,9,9,9,9,9,9,9,9,9,9,9,9,9,9,9,9,9,9,9,9,9,9,14,9,131,114,58,10],
[132,9,9,9,9,9,9,9,131,78,55,9,9,9,9,9,9,9,9,9,9,9,9,9,9,9,9,9,9,9,119,87,118,9,9,9,9,9,9,9,9,9,9,9,133,59,34,10],
[9,9,9,9,9,9,9,9,109,132,78,55,9,9,9,9,9,9,9,9,9,9,9,9,9,9,9,9,9,132,108,108,117,132,9,9,9,9,9,9,9,9,9,9,9,58,10,10],
[9,9,9,9,9,9,9,9,120,117,112,45,9,9,9,9,9,87,118,9,9,9,9,9,112,113,11,9,59,18,18,60,109,112,112,112,9,9,9,9,9,9,9,9,59,34,10,10],
[9,9,9,9,9,9,9,9,9,109,112,78,55,9,21,9,133,108,108,117,9,9,133,114,108,117,111,9,58,10,10,48,109,112,112,114,113,132,9,21,9,9,9,59,34,10,10,10],
[9,9,9,9,9,9,9,9,9,131,117,112,78,25,26,27,80,55,9,120,113,116,115,110,43,55,133,59,34,10,10,48,109,112,114,110,43,80,25,26,27,80,76,77,10,10,10,10],
[9,9,9,9,9,9,9,9,9,9,120,112,133,30,31,32,9,78,80,55,117,114,110,43,71,78,76,77,10,10,10,48,120,132,43,80,71,9,30,31,32,9,131,82,10,10,10,10],
[9,9,9,9,9,9,9,9,9,9,9,9,9,9,9,9,9,9,9,78,55,133,43,71,113,112,131,82,10,10,10,74,75,80,71,9,9,9,9,9,9,9,113,62,63,33,10,10],
[9,9,9,9,9,9,9,9,9,9,9,9,9,9,9,9,9,9,9,9,78,80,71,119,116,112,111,58,10,10,10,81,9,9,9,9,9,9,9,9,9,9,117,115,133,58,10,10],
[9,9,9,9,9,9,9,9,9,9,9,9,9,9,9,9,9,9,9,9,133,112,113,115,113,115,111,62,33,10,36,61,131,9,9,9,9,9,9,9,9,9,9,117,111,58,10,10],
[9,9,9,9,9,9,9,9,9,9,87,118,11,9,9,9,9,9,9,9,9,117,113,116,112,112,118,11,58,10,48,113,111,9,9,9,9,9,9,9,9,9,9,9,111,58,10,10],
[9,9,9,9,9,9,9,9,9,119,116,112,113,131,9,9,9,9,9,9,9,109,112,113,116,112,115,111,58,10,48,112,118,133,9,9,9,9,9,9,9,9,9,9,131,58,10,10]]