[[140,119,140,119,11,13,120,120,119,119,119,140,140,119,120,136,12,12,12,12,28,29,108,109,9,11,9,9,9,11,9,9,119,120,119,140,135,12,12,12,12,12,12,12,12,12,12,12],
[119,140,119,120,119,120,119,140,140,119,140,119,140,119,120,136,12,12,12,12,40,41,114,115,9,9,35,11,9,9,11,120,120,119,120,140,136,12,12,12,12,12,12,12,12,12,12,12],
[37,50,54,64,120,119,63,54,37,54,50,37,64,140,119,136,12,12,12,12,98,99,9,9,11,11,9,9,9,9,9,9,9,9,9,9,135,12,12,12,12,12,12,12,12,12,12,12],
[9,9,9,62,50,37,65,9,9,9,9,9,62,64,9,80,78,79,33,12,87,88,9,9,9,9,9,9,9,9,9,9,9,9,9,9,80,79,77,78,33,12,12,12,12,12,12,12],
[9,9,9,9,9,9,9,9,9,9,9,9,9,20,9,92,90,91,45,12,75,76,9,9,9,10,9,10,9,9,9,10,9,10,9,9,92,91,89,90,45,12,12,12,12,12,12,12],
[9,9,11,10,10,10,10,10,9,9,9,9,21,22,23,9,9,9,9,80,108,109,11,9,9,9,9,9,9,9,9,10,10,10,9,9,9,9,9,9,9,135,12,12,12,12,12,12],
[9,9,9,9,9,11,9,11,9,9,10,9,9,24,9,11,11,9,9,92,114,115,9,13,10,9,9,9,9,9,9,9,10,9,10,11,11,11,9,9,9,136,12,12,12,12,12,12],
[9,9,10,9,9,119,120,11,9,9,9,9,9,38,138,9,9,9,9,9,9,9,9,9,9,9,9,9,9,9,9,9,9,11,11,9,9,10,9,9,9,134,12,12,12,12,12,12],
[9,9,9,9,9,140,119,10,120,9,9,9,9,51,139,116,9,9,11,9,9,9,9,11,9,9,9,9,9,9,9,9,9,9,11,9,9,11,9,9,9,80,78,33,12,12,12,12],
[9,9,9,11,119,140,140,119,120,9,9,9,9,62,64,137,139,117,9,9,9,9,9,9,9,9,9,9,9,10,9,9,11,9,9,9,9,9,9,9,9,92,90,45,12,12,12,12],
[9,9,120,119,140,140,119,140,119,9,11,9,9,9,62,37,37,37,64,9,9,9,9,9,9,9,9,9,9,9,9,9,9,9,9,9,9,9,9,9,9,9,9,9,136,12,12,12],
[9,9,119,140,119,140,140,119,120,9,9,119,140,9,9,9,9,9,62,64,9,9,9,9,9,9,9,9,9,9,9,9,11,9,9,10,9,9,9,9,9,9,9,9,135,12,12,12],
[9,120,119,140,140,140,140,119,9,9,10,119,140,120,9,10,9,9,9,38,9,9,10,9,9,9,9,10,9,9,9,9,9,9,10,9,9,9,9,10,9,9,9,9,134,12,12,12],
[9,120,119,119,120,119,119,120,10,11,10,120,9,10,9,9,9,9,21,22,23,9,9,9,9,9,9,9,9,9,9,9,9,9,9,9,9,10,9,9,9,9,9,9,80,33,12,12],
[9,9,9,120,10,10,120,9,9,9,9,9,9,9,9,9,9,9,21,22,23,9,9,9,9,9,9,9,9,9,9,9,9,10,9,9,9,9,10,9,9,9,9,9,92,45,12,12],
[9,9,9,9,9,9,9,9,9,9,9,9,120,9,10,10,9,9,9,24,130,132,133,100,101,9,9,9,10,9,9,9,11,9,9,10,11,9,9,10,10,9,9,9,9,9,136,12],
[120,9,120,9,9,9,9,9,9,9,10,140,119,120,9,9,9,9,63,65,135,12,12,98,99,9,9,9,10,9,9,9,11,9,9,9,10,10,9,10,9,9,9,9,9,9,135,12],
[119,120,9,9,9,9,9,9,9,119,140,119,119,11,9,10,9,63,65,9,125,12,12,75,76,9,9,9,9,9,9,9,9,9,10,10,9,10,9,9,9,10,9,9,9,9,134,12],
[140,119,119,120,9,9,9,9,9,10,119,140,10,9,9,10,63,65,130,126,127,12,12,75,76,9,9,10,11,9,10,9,9,9,10,9,9,10,9,9,9,9,10,9,9,9,135,12],
[140,140,140,140,119,9,9,9,9,120,9,9,10,11,10,9,38,9,135,12,12,28,29,108,109,9,9,10,9,9,9,9,9,9,10,11,9,9,9,9,9,9,10,9,9,9,134,12],
[140,119,140,140,119,120,10,10,9,9,9,9,11,9,10,9,55,9,135,12,12,40,41,114,115,9,9,10,9,9,9,10,9,9,9,9,9,9,10,9,9,10,9,9,9,9,134,12],
[119,140,140,119,140,120,9,9,9,9,11,10,10,9,9,9,51,9,80,79,77,108,109,9,9,9,9,10,9,9,9,9,9,9,10,9,11,9,9,10,10,9,9,9,9,9,125,12],
[140,119,140,119,119,9,9,9,9,11,11,9,119,120,9,9,20,9,92,91,89,114,115,9,9,9,9,10,9,9,9,10,10,9,9,9,11,9,9,10,9,9,9,130,132,126,127,12],
[140,140,119,120,9,9,9,9,9,9,120,119,140,11,9,21,22,23,9,9,9,9,9,9,9,9,9,9,9,9,9,9,9,9,9,9,11,9,10,9,9,9,9,135,12,12,12,12],
[119,119,120,9,9,9,9,10,10,9,9,119,119,10,9,21,22,23,9,10,9,11,10,9,9,9,10,11,9,9,9,9,9,9,10,9,11,9,10,9,9,9,9,135,12,12,12,12],
[120,120,9,9,9,9,9,11,10,9,9,9,9,10,9,9,51,9,9,9,9,9,9,9,130,133,132,100,101,9,9,9,10,9,9,9,9,9,9,10,9,9,9,136,12,12,12,12],
[120,10,11,9,9,9,11,10,10,9,9,9,9,9,9,9,55,117,9,9,9,9,9,9,136,12,12,87,88,9,9,9,9,9,9,10,9,9,9,10,9,9,9,134,12,12,12,12],
[9,9,11,10,11,11,9,9,9,9,11,9,9,10,9,9,51,116,10,9,9,9,9,11,135,12,12,75,76,9,9,9,9,9,9,9,9,10,9,9,10,9,9,134,12,12,12,12],
[9,9,9,9,9,9,10,9,9,9,10,9,9,9,10,9,55,139,9,9,9,9,10,9,136,12,12,98,99,9,9,9,10,9,9,9,9,9,9,9,10,9,9,136,12,12,12,12],
[120,9,10,11,10,10,10,9,140,119,120,9,9,9,9,10,51,9,138,9,9,9,10,9,136,12,12,87,88,9,9,9,9,9,10,9,9,10,9,10,10,9,9,134,12,12,12,12],
[119,120,10,11,9,9,9,120,119,119,11,9,9,9,9,10,38,116,9,9,9,9,9,9,135,12,12,98,99,9,9,9,9,9,10,9,10,10,10,9,9,9,9,80,78,30,12,12],
[119,119,9,120,9,9,10,120,9,9,10,9,9,10,10,9,62,64,139,9,9,9,9,9,136,12,12,75,76,9,9,9,9,11,9,9,9,9,9,9,9,9,9,92,90,42,12,12],
[140,140,119,120,9,9,10,9,9,9,9,9,9,9,9,9,9,62,64,117,9,11,10,9,80,78,79,108,109,9,9,10,9,9,11,9,9,9,9,9,9,9,9,9,9,9,136,12],
[140,119,140,11,120,9,10,9,9,10,9,9,130,131,132,133,100,101,62,64,9,9,9,9,92,90,91,114,115,9,9,10,9,9,9,9,9,9,9,9,9,9,9,9,9,9,134,12],
[140,140,119,11,9,10,9,9,10,9,9,9,136,12,12,12,59,60,9,62,64,9,9,10,9,9,9,9,9,9,9,9,10,9,9,9,9,9,9,10,9,10,11,9,10,9,135,12],
[119,140,140,119,9,10,9,10,10,9,9,9,136,12,12,12,12,12,100,101,62,64,9,9,9,9,9,10,9,9,9,9,9,9,10,10,9,9,9,10,9,9,9,9,9,9,135,12],
[140,119,119,120,9,11,9,9,10,9,9,9,125,12,12,12,12,12,59,60,9,62,64,10,9,9,9,9,9,9,9,9,9,9,9,9,9,9,9,11,9,9,9,9,9,9,125,12],
[119,119,120,10,9,9,10,9,9,9,130,126,127,12,12,12,12,12,12,12,100,101,51,10,9,9,9,9,9,9,9,9,9,9,9,9,9,9,10,9,9,9,9,130,133,126,127,12],
[119,120,9,9,10,10,9,9,9,9,136,12,12,12,12,12,12,12,12,12,87,88,38,9,9,9,9,10,9,9,9,9,9,9,9,9,9,10,9,9,9,9,9,135,12,12,12,12],
[120,9,9,10,10,9,9,10,9,9,80,79,77,79,33,12,12,12,31,32,108,109,51,9,10,9,9,9,9,9,9,9,9,10,9,11,9,9,9,9,9,10,9,134,12,12,12,12],
[9,11,9,9,9,9,9,9,9,9,92,91,89,91,45,12,12,12,43,44,114,115,55,9,10,9,9,9,9,9,9,9,9,9,130,133,131,132,133,100,101,9,9,136,12,12,12,12],
[10,11,9,9,9,9,9,10,9,9,9,9,9,9,9,80,78,77,108,109,63,56,65,9,9,9,9,9,9,9,9,10,11,9,135,12,12,12,12,59,60,9,9,122,12,12,12,12],
[120,10,9,120,9,10,9,10,9,9,9,9,9,9,11,92,90,89,114,115,20,9,9,9,9,9,9,9,9,9,9,9,9,9,135,12,12,12,12,12,12,133,123,124,12,12,12,12],
[119,120,120,9,9,10,9,10,9,10,9,9,9,9,9,9,9,9,11,21,22,23,9,9,9,9,9,9,9,9,9,9,11,9,136,12,12,12,12,12,12,12,12,12,12,12,12,12],
[140,119,120,11,9,9,9,9,11,9,9,9,120,120,119,9,9,9,9,21,22,23,119,9,9,120,9,9,9,9,9,9,10,9,134,12,12,12,12,12,12,12,12,12,12,12,12,12],
[119,140,119,120,9,10,10,11,9,9,9,120,119,119,140,119,140,119,119,63,65,119,140,119,120,120,120,9,9,9,9,9,9,9,125,12,12,12,12,12,12,12,12,12,12,12,12,12],
[140,119,119,120,9,9,9,9,9,120,119,119,119,119,140,140,119,119,63,65,119,119,140,140,140,119,119,119,120,130,133,132,131,126,127,12,12,12,12,12,12,12,12,12,12,12,12,12],
[140,140,140,119,120,9,9,9,120,119,119,140,119,140,119,140,119,63,65,119,140,140,140,119,140,119,140,140,119,134,12,12,12,12,12,12,12,12,12,12,12,12,12,12,12,12,12,12]]