[[9,9,9,9,9,9,9,9,9,9,9,9,9,9,9,9,9,9,9,9,9,9,9,9,9,9,9,9,9,9,9,9,9,9,9,9,9,9,9,9,9,9,9,9,9,9,9,115],
[9,9,9,9,9,9,9,9,9,9,9,9,9,9,9,9,9,9,9,9,9,9,9,9,9,9,9,9,9,9,9,9,9,9,9,9,9,9,21,9,9,9,9,9,9,9,9,116],
[9,9,9,9,9,9,9,9,9,9,9,9,9,9,9,9,9,9,9,9,9,9,9,9,21,9,9,9,9,9,9,9,9,43,57,56,57,25,26,27,55,9,9,9,9,9,9,114],
[9,9,9,9,9,9,9,9,9,9,9,9,9,9,9,9,9,9,9,9,9,43,56,25,26,27,55,9,9,9,9,9,9,72,114,112,16,14,31,17,72,9,9,9,9,9,9,113],
[9,9,9,9,9,9,9,9,9,9,9,9,9,9,9,9,9,9,9,9,9,72,123,132,31,9,73,9,9,9,9,9,9,72,17,9,9,9,9,9,72,9,9,9,9,9,9,112],
[9,9,9,9,9,9,9,9,9,9,9,9,9,9,9,9,9,9,9,9,9,78,56,55,131,9,72,9,9,9,9,9,9,72,118,16,14,116,132,9,78,55,9,9,9,9,9,115],
[9,9,9,9,9,9,9,9,9,9,9,9,9,21,9,9,9,9,9,9,9,9,9,44,115,9,73,9,9,9,9,9,9,78,56,56,56,55,16,9,9,72,9,9,9,9,9,116],
[43,56,57,55,9,9,9,9,9,9,9,43,25,26,27,79,57,79,55,9,9,9,9,73,111,9,72,9,9,9,9,9,9,9,9,9,9,44,115,9,9,73,9,9,9,9,9,112],
[71,112,15,78,55,9,9,9,21,9,9,44,112,31,9,133,112,113,73,9,9,9,9,20,131,9,78,55,9,9,9,9,9,9,9,9,9,44,14,9,9,72,9,9,9,9,9,116],
[114,110,9,133,78,79,57,25,26,27,79,71,113,9,9,9,9,116,72,9,9,9,22,23,24,9,9,78,56,57,56,55,9,9,9,9,9,44,116,9,9,73,9,9,9,9,9,115],
[112,11,9,9,9,133,16,131,31,123,110,17,16,9,9,9,9,132,73,9,9,9,9,29,9,9,9,116,124,114,117,72,9,9,9,9,43,71,16,9,9,72,9,9,9,9,9,112],
[115,132,9,9,9,9,9,9,9,9,9,9,9,9,9,9,9,14,78,56,56,57,56,71,133,9,9,132,108,110,16,72,9,9,9,9,44,13,133,9,131,78,56,57,56,55,9,115],
[116,110,9,9,9,9,9,9,9,9,9,9,9,9,9,9,9,13,133,116,17,9,13,113,131,9,9,9,9,9,15,72,9,9,9,9,44,132,9,9,132,115,9,16,132,72,9,109],
[110,9,9,9,132,113,70,112,9,113,132,9,9,9,9,9,9,9,9,9,9,9,9,9,9,9,9,9,9,9,16,72,16,9,21,133,44,9,9,9,9,9,9,9,9,72,9,115],
[9,9,9,43,56,57,56,56,57,55,116,115,9,9,9,9,9,9,9,9,9,9,9,9,9,9,9,9,9,9,14,78,57,25,26,27,71,131,9,9,9,9,9,9,9,72,9,115],
[131,21,9,72,116,13,112,133,9,78,55,133,9,9,9,9,9,9,9,9,9,9,9,9,9,9,9,9,9,9,132,13,131,132,31,115,117,111,9,9,9,9,9,9,9,20,9,120],
[25,26,27,71,9,9,9,9,9,9,73,9,9,9,9,9,9,9,9,9,9,9,9,9,9,9,9,9,9,9,9,9,9,9,9,9,132,131,9,9,9,9,9,9,22,23,24,9],
[110,31,132,9,9,9,9,9,9,132,72,131,9,9,9,9,9,9,9,9,43,56,57,56,57,56,57,55,132,9,9,9,9,9,9,9,9,9,9,9,9,9,9,9,9,29,9,9],
[9,9,9,9,43,57,56,56,57,56,71,113,9,9,9,9,9,9,9,9,72,114,13,9,16,115,117,73,112,9,9,9,9,9,9,9,9,9,9,9,9,9,9,43,56,71,9,9],
[9,9,9,9,73,112,115,116,112,115,116,110,9,9,9,9,9,9,9,9,73,9,9,9,9,9,132,20,133,9,9,9,9,9,9,9,9,9,9,9,9,9,9,72,114,131,9,9],
[9,9,9,9,20,132,9,120,132,133,9,9,9,9,9,9,9,21,9,9,72,131,9,9,9,9,22,23,24,9,9,9,9,9,9,9,9,9,9,9,43,57,56,71,14,9,9,9],
[9,9,9,22,23,24,9,9,9,9,9,9,43,79,79,57,25,26,27,79,71,113,9,9,9,9,9,29,14,9,9,9,9,9,9,9,9,9,9,9,73,16,132,17,133,9,9,9],
[9,9,9,9,29,9,9,9,9,9,9,9,72,113,9,116,133,31,131,115,114,132,9,9,9,9,9,78,55,132,9,9,9,9,9,9,9,9,9,9,72,112,9,9,9,9,9,119],
[9,9,9,9,78,55,9,9,9,9,9,9,73,16,9,9,9,9,9,9,9,9,9,9,9,9,9,9,72,112,9,9,9,9,21,123,9,21,9,9,73,15,9,9,9,9,116,112],
[9,9,9,9,9,72,16,9,9,9,9,9,72,113,9,9,9,9,9,9,9,9,9,9,9,9,9,9,73,16,9,9,43,25,26,27,25,26,27,57,71,132,9,9,9,116,113,114],
[9,9,9,9,9,73,15,119,116,9,9,9,73,115,9,9,9,9,9,9,9,9,9,9,9,21,9,43,71,113,9,9,72,131,31,9,124,31,116,131,9,9,9,9,9,132,117,115],
[9,9,9,9,16,72,13,87,111,9,21,133,72,123,9,9,9,9,9,9,9,43,57,56,25,26,27,71,114,133,9,9,73,132,9,9,9,9,9,9,9,9,9,9,9,9,109,113],
[9,9,9,9,15,72,115,115,43,25,26,27,71,116,9,9,43,56,57,56,56,71,132,16,131,31,132,16,131,9,9,9,20,133,9,9,9,9,9,9,9,9,9,9,9,9,120,117],
[11,9,9,9,116,73,118,87,72,111,31,131,16,132,9,9,72,113,9,115,16,133,9,9,9,9,9,9,9,9,9,22,23,24,9,9,9,9,9,9,9,9,9,9,9,9,119,112],
[112,9,9,9,115,78,56,56,71,133,9,9,9,9,9,9,73,124,9,9,9,9,9,9,9,9,9,9,9,9,9,9,29,133,9,9,9,9,9,9,9,9,9,9,9,9,109,116],
[113,112,9,9,120,117,113,17,9,9,9,9,9,9,43,56,71,16,9,9,9,21,9,9,9,9,9,9,9,9,9,9,78,55,112,9,9,9,9,9,9,9,9,9,9,9,109,118],
[115,116,111,9,9,9,9,9,9,43,56,57,56,56,71,112,133,9,9,43,25,26,27,55,70,132,9,9,9,9,9,9,123,72,115,16,14,132,9,9,9,9,9,9,9,9,109,115],
[87,112,115,9,9,9,9,9,9,72,115,15,16,14,9,9,9,9,9,72,15,31,17,72,124,112,9,9,9,9,9,9,112,78,57,56,56,55,9,9,9,9,9,9,9,9,109,112],
[116,113,112,116,9,9,131,43,56,71,131,9,9,9,9,9,9,9,9,73,9,9,9,78,56,55,115,9,9,9,9,9,9,116,112,116,112,72,118,133,9,9,9,9,9,119,87,116],
[112,115,110,9,9,9,109,72,121,122,9,9,9,9,43,56,55,9,9,72,111,9,9,9,9,20,112,9,9,9,9,9,9,133,108,110,120,73,112,112,9,9,9,9,9,109,114,113],
[113,112,9,9,9,132,87,73,41,42,9,21,9,9,72,115,78,57,56,71,115,9,9,9,22,23,24,9,9,9,9,9,21,9,9,9,43,71,116,132,9,9,9,9,9,109,112,115],
[112,110,9,9,9,131,117,78,57,56,25,26,27,57,71,116,112,9,112,132,9,9,9,9,9,29,9,9,9,9,43,25,26,27,57,56,71,112,112,9,9,9,9,9,119,87,114,112],
[112,9,9,9,9,9,133,112,115,112,131,31,132,108,112,133,9,9,9,9,9,43,56,57,56,71,9,43,56,57,71,111,31,133,112,113,17,16,9,9,9,9,9,9,87,112,115,116],
[111,9,131,9,9,9,9,9,116,132,9,9,9,9,9,9,9,9,9,9,9,72,115,115,131,9,9,72,113,116,113,115,9,9,9,133,9,9,9,9,9,9,119,116,115,116,112,112],
[112,11,9,9,9,9,9,9,112,9,9,9,9,9,9,9,9,9,9,9,9,73,112,9,9,9,9,73,116,112,116,111,9,9,9,9,9,9,9,9,9,133,87,115,112,113,116,115],
[115,112,70,9,9,9,9,9,9,9,9,9,9,9,9,9,9,9,9,43,56,71,13,9,9,9,9,73,115,113,112,111,132,9,9,9,9,9,9,9,9,109,116,113,113,112,115,112],
[112,113,112,113,131,9,9,9,9,9,9,9,9,9,9,9,9,9,9,72,115,108,131,9,9,9,9,72,112,115,113,116,70,70,112,70,70,131,9,9,9,109,112,116,115,116,112,115],
[116,112,116,112,111,9,132,9,9,119,11,9,9,9,9,9,9,9,9,73,132,9,9,9,9,9,43,71,113,112,116,112,115,112,112,115,112,118,70,70,70,87,113,112,112,114,112,118],
[113,115,113,115,111,9,9,9,9,120,110,9,9,9,9,9,9,9,22,23,24,9,9,43,56,57,71,113,112,113,112,113,112,113,112,113,112,115,112,113,112,116,114,115,113,115,112,113],
[112,116,112,116,118,70,70,70,11,9,9,9,9,9,9,9,9,9,9,29,131,9,9,73,113,112,112,116,112,114,113,112,112,112,115,112,113,112,112,116,112,113,113,116,112,115,116,115],
[87,115,112,112,115,113,116,113,118,11,9,9,9,9,9,131,70,70,112,73,115,9,9,72,116,115,116,113,112,113,112,112,115,113,112,116,112,114,117,112,115,112,116,112,114,112,115,112],
[113,112,113,87,112,116,112,112,115,112,115,11,119,70,70,87,112,113,116,78,57,56,57,71,112,113,112,115,112,115,112,113,112,116,112,115,116,118,87,112,116,112,113,115,116,112,113,116],
[116,113,115,112,113,112,113,114,116,112,113,118,87,113,112,115,113,112,115,112,116,113,114,112,113,112,115,112,113,116,112,116,113,112,114,113,112,115,112,113,112,116,115,112,116,117,115,114]]