[[116,115,114,110,9,9,9,9,9,120,112,116,113,115,45,112,113,110,9,9,9,133,9,9,120,116,113,115,118,115,113,115,116,108,112,113,115,113,116,114,112,115,113,116,118,112,115,113],
[87,112,110,9,9,9,9,9,9,9,9,9,120,116,20,133,110,9,9,9,9,9,9,9,9,115,112,115,116,115,112,115,114,116,115,118,115,115,114,115,108,113,112,115,117,116,114,115],
[113,110,9,9,9,9,9,9,9,9,9,9,9,22,23,24,9,9,132,70,11,9,9,9,9,9,120,116,113,114,115,115,118,115,112,113,112,114,110,9,9,131,9,9,120,115,113,115],
[115,11,9,9,9,9,9,9,9,9,9,9,9,9,29,9,9,9,131,117,118,116,9,9,14,9,9,9,132,115,116,113,115,113,115,116,115,115,9,132,9,9,9,9,9,112,115,118],
[112,113,11,9,9,9,9,9,9,16,9,9,9,9,78,55,131,9,9,109,116,118,11,9,9,9,9,9,9,9,115,108,115,116,110,115,113,111,9,9,9,9,9,132,9,115,113,115],
[118,116,133,9,9,9,9,9,9,9,9,9,9,9,132,72,115,9,9,109,113,87,111,9,9,9,9,9,9,9,9,9,132,9,9,115,112,115,9,9,9,124,9,9,9,109,112,113],
[113,110,9,9,9,9,9,13,9,9,9,9,9,9,115,45,116,11,9,132,108,108,133,9,9,9,9,9,9,9,9,9,9,9,9,132,116,110,9,9,133,9,9,9,9,115,116,112],
[110,9,9,9,9,9,9,9,9,15,9,9,9,9,109,72,113,112,9,9,9,9,9,9,9,9,9,9,9,9,9,9,9,9,9,9,9,9,9,9,9,9,9,131,9,112,115,116],
[9,9,9,9,9,9,9,9,9,9,9,9,9,9,131,78,80,56,55,9,9,9,9,9,9,9,9,9,9,9,9,9,9,9,9,9,9,9,9,9,9,132,9,9,9,113,118,113],
[9,9,9,9,9,9,9,9,9,9,9,9,9,9,9,9,9,9,72,9,9,9,9,9,123,9,9,9,9,9,9,9,9,9,9,9,9,16,9,9,9,9,9,9,112,116,112,115],
[9,9,9,9,9,9,9,9,9,9,9,9,9,9,9,9,9,43,71,131,9,9,9,9,9,9,9,9,9,9,9,9,9,9,9,9,9,9,9,13,9,9,9,9,120,115,115,118],
[9,9,9,9,9,9,9,9,9,9,9,9,9,9,132,113,9,72,116,110,9,9,9,9,9,9,9,9,9,9,9,9,9,9,9,9,9,9,9,9,9,9,17,9,9,9,113,115],
[9,9,9,132,70,11,9,9,9,9,9,9,9,9,109,115,112,45,111,9,9,9,9,9,9,9,9,9,9,9,9,9,9,9,9,9,9,9,9,9,9,9,9,9,9,9,109,112],
[9,9,9,109,116,118,70,131,9,9,9,9,9,116,115,123,115,72,115,9,9,9,9,9,9,9,9,9,131,116,9,9,9,9,9,9,9,9,9,9,9,9,9,9,9,9,115,113],
[9,9,9,116,115,113,112,111,9,9,9,9,9,9,120,116,113,72,113,9,21,9,116,132,131,9,9,9,109,111,9,9,9,124,9,9,9,9,9,9,9,9,9,9,133,9,120,116],
[9,9,9,109,112,115,116,111,9,9,9,9,9,9,9,112,115,78,80,25,26,27,56,55,116,9,9,9,133,131,9,9,9,9,9,9,9,9,9,9,9,9,9,9,9,9,9,120],
[9,9,9,120,117,116,113,118,132,9,9,9,9,9,9,9,120,131,110,9,31,9,112,72,113,11,9,9,9,9,9,9,9,9,9,9,9,9,9,9,9,9,132,131,9,9,9,43],
[9,9,9,9,109,115,116,115,111,9,9,9,9,9,9,9,9,9,9,9,9,9,113,72,112,133,9,9,9,9,9,9,113,17,9,112,132,9,9,14,9,9,109,118,70,70,11,45],
[9,9,9,9,132,108,108,117,111,9,9,9,9,9,9,9,9,9,9,9,9,9,120,78,55,110,9,9,9,9,9,9,59,18,18,60,116,9,9,9,9,9,116,113,115,116,111,73],
[9,9,9,9,9,9,9,120,133,9,9,9,9,9,9,9,9,9,9,9,9,9,9,9,20,9,9,9,9,9,9,9,58,10,10,48,113,9,9,9,9,9,109,118,112,114,110,72],
[70,11,9,9,9,9,9,9,9,9,9,9,9,14,9,9,9,9,9,9,9,9,9,22,23,24,9,9,9,9,133,116,58,10,10,48,111,9,9,9,9,9,9,112,116,132,9,73],
[115,111,9,9,9,9,9,9,9,9,9,9,9,9,9,9,9,9,9,9,9,9,9,9,29,9,9,9,9,9,112,59,34,10,10,48,116,9,15,16,9,9,9,9,9,9,9,72],
[116,111,9,9,9,9,9,9,9,9,9,9,9,9,9,9,9,9,9,9,9,9,9,132,72,9,9,9,9,9,9,58,10,10,10,74,75,56,55,115,9,9,9,9,9,9,9,44],
[114,118,11,9,9,9,9,9,9,9,9,9,9,9,9,9,9,9,9,9,9,9,9,116,78,79,55,9,9,9,9,58,10,10,10,81,116,112,72,113,9,9,9,9,9,9,9,73],
[113,113,112,133,9,9,9,9,9,9,9,9,9,9,9,9,9,9,9,9,9,9,9,133,113,112,72,9,9,9,9,58,10,10,36,61,116,115,45,110,9,9,9,9,9,9,9,45],
[117,115,110,9,9,9,9,9,9,9,9,9,9,9,13,9,9,9,9,9,9,9,9,9,9,109,12,9,9,9,9,58,10,10,48,113,115,110,72,9,9,9,9,9,132,9,21,78],
[114,110,9,9,9,9,9,9,9,9,9,9,9,9,9,9,9,9,9,9,9,9,9,9,133,59,46,47,18,18,18,34,10,10,48,112,116,9,78,56,80,55,131,133,43,25,26,27],
[110,9,9,9,9,9,17,9,9,9,9,9,9,9,9,9,9,9,9,9,9,9,9,9,132,58,10,10,10,10,10,10,10,10,10,60,133,9,9,133,131,78,56,80,71,14,31,133],
[9,9,9,9,9,9,9,9,9,9,9,9,9,9,9,9,9,9,9,9,9,9,9,9,9,58,10,10,10,10,10,10,10,10,10,48,9,9,9,9,9,132,133,132,9,9,9,9],
[9,9,9,9,9,9,9,9,9,9,9,9,9,9,9,9,9,9,9,9,133,131,9,120,115,58,10,10,10,10,10,10,10,10,10,48,124,9,9,9,9,9,9,9,9,9,9,9],
[9,9,9,9,9,9,9,9,9,9,9,9,9,9,9,9,9,9,9,9,113,59,18,18,18,34,10,10,10,10,10,10,10,10,10,48,116,115,70,113,116,70,70,116,132,9,9,131],
[9,9,9,9,9,9,9,9,9,9,9,9,9,9,9,9,9,9,9,9,13,58,10,10,10,10,10,10,10,10,10,10,10,10,10,35,18,18,18,18,18,18,18,60,112,9,9,9],
[70,70,11,9,9,9,9,9,9,9,9,9,9,9,9,9,9,9,9,9,115,58,10,10,10,10,10,10,10,10,10,10,10,10,10,10,10,10,10,10,10,10,10,48,9,9,9,9],
[113,112,118,11,9,9,9,9,9,9,9,9,9,9,9,9,9,9,9,9,116,58,10,10,10,10,10,10,10,10,10,10,10,10,10,10,10,10,10,10,10,10,10,48,116,9,9,9],
[117,116,115,111,9,9,9,9,9,9,9,9,9,9,9,9,9,9,9,9,120,58,10,10,10,10,10,10,10,10,10,10,10,10,10,10,10,10,10,10,10,10,10,48,111,9,13,9],
[115,114,113,111,9,9,9,9,9,9,9,9,9,9,9,9,9,9,9,9,9,58,10,10,10,10,10,10,10,10,10,10,10,10,10,10,10,10,10,36,63,63,63,61,112,9,9,9],
[112,116,114,110,9,9,15,9,9,9,9,9,9,9,9,9,9,9,112,116,133,58,10,10,10,10,10,10,10,10,10,10,10,10,10,10,10,10,10,48,113,116,9,132,133,9,9,9],
[118,115,111,9,9,9,9,9,9,9,9,9,9,9,9,9,9,132,115,112,59,34,10,10,10,10,10,10,10,10,10,10,10,10,10,10,10,10,10,48,112,111,9,9,9,9,9,9],
[113,116,116,9,9,9,9,9,9,9,9,9,9,9,9,9,9,9,116,116,62,63,63,63,63,33,10,10,10,10,10,10,10,10,10,10,10,10,10,48,116,110,9,9,9,9,9,9],
[87,112,111,9,14,9,9,9,9,9,9,9,9,9,16,9,9,9,120,113,116,113,116,112,115,58,10,10,10,10,10,10,36,63,63,63,63,33,10,48,131,9,9,9,9,9,9,9],
[115,116,111,9,9,9,9,9,9,9,9,9,9,9,9,9,9,9,9,133,115,116,114,117,116,58,10,10,10,10,10,10,48,113,9,120,116,58,10,48,9,9,9,9,9,9,9,9],
[112,113,118,70,70,11,9,9,9,9,9,9,9,9,9,9,9,9,9,9,120,116,118,87,115,58,10,10,10,10,10,10,48,111,9,9,112,62,63,61,11,9,9,9,9,9,9,132],
[116,118,116,115,112,118,11,9,9,9,9,9,9,9,9,9,9,9,9,9,9,9,116,112,116,62,63,63,63,63,63,63,61,116,9,9,120,133,9,120,133,9,9,9,9,9,9,9],
[117,115,112,113,114,108,110,9,9,9,9,9,9,9,9,9,9,9,9,9,9,9,120,116,112,113,116,9,133,116,9,131,133,114,9,9,9,9,9,9,9,9,9,9,9,9,9,9],
[120,108,108,108,110,9,9,9,9,9,9,9,9,9,9,9,9,9,9,9,9,9,9,131,9,9,9,9,9,9,9,9,9,9,9,9,9,9,9,9,9,9,9,9,9,9,9,9],
[9,9,9,9,9,9,9,133,9,9,9,9,9,9,9,9,9,9,9,9,9,9,9,9,9,9,9,9,9,9,9,9,9,9,9,9,9,9,9,9,9,9,9,9,9,9,9,9],
[70,11,9,9,9,9,9,9,9,9,9,9,9,9,113,131,133,9,9,9,9,9,9,9,9,9,9,9,9,9,9,9,9,9,9,9,9,9,9,9,9,9,9,9,131,9,9,9],
[116,118,11,9,9,9,9,9,9,9,9,9,9,119,116,115,118,11,9,9,9,9,9,9,9,9,9,9,9,9,9,9,132,9,9,9,9,9,9,9,9,9,9,9,9,9,9,9]]