[[87,11,58,10,10,10,10,10,10,10,10,10,10,10,10,10,10,10,10,10,10,10,10,10,10,10,10,48,115,87,115,112,113,116,115,112,78,55,116,113,118,9,9,9,9,9,9,9],
[119,110,62,63,63,63,63,63,63,33,10,10,10,10,10,10,10,10,10,10,10,10,10,10,10,10,36,61,112,114,9,113,124,112,9,9,113,78,55,123,115,110,9,9,9,9,9,9],
[116,9,113,116,115,116,112,115,116,58,10,10,10,10,10,10,10,10,10,10,10,10,10,10,10,10,48,113,9,9,9,118,9,115,112,9,115,19,20,9,9,9,9,13,9,9,9,9],
[115,11,9,115,110,123,120,116,113,58,10,10,10,10,10,10,10,10,10,10,10,10,10,10,10,10,48,116,9,115,9,9,9,9,120,9,9,22,23,24,9,9,9,9,9,9,9,9],
[112,133,9,9,9,9,14,59,18,34,10,10,36,63,63,33,10,10,10,10,10,10,10,10,10,10,35,18,18,18,60,9,9,9,9,9,9,28,29,124,116,9,131,9,9,9,9,9],
[113,110,9,9,9,9,9,58,10,10,10,10,48,116,113,62,63,63,33,10,10,10,10,10,10,10,10,10,10,10,48,113,116,14,131,9,9,9,78,55,113,11,9,9,9,132,9,9],
[111,9,9,9,9,9,131,58,10,10,10,10,10,116,120,116,15,113,58,10,10,10,10,10,10,10,10,10,10,10,35,18,18,60,11,9,9,119,113,73,116,113,118,9,9,9,9,9],
[118,70,116,70,11,9,9,62,63,63,33,36,61,115,9,9,9,9,62,63,63,63,63,33,10,10,10,10,10,10,10,10,10,48,113,11,9,115,112,78,55,115,113,116,9,9,9,9],
[116,115,103,116,111,9,9,9,115,116,62,61,113,116,9,9,9,115,112,116,113,116,112,58,10,10,10,10,10,10,10,10,10,35,60,111,9,120,109,116,78,79,56,55,9,119,115,87],
[115,106,113,115,111,9,9,9,9,9,13,9,9,112,9,9,9,120,108,112,110,9,115,58,10,10,10,10,10,10,10,10,36,63,61,116,9,14,112,115,113,115,116,73,113,112,113,116],
[111,116,113,114,9,9,9,9,9,9,9,9,9,9,9,9,9,9,9,9,43,57,76,77,10,10,10,10,10,10,10,10,48,113,9,9,9,9,9,112,17,112,43,71,116,113,122,117],
[112,112,116,9,9,9,9,9,9,9,9,9,9,9,9,9,9,9,9,9,45,112,116,62,63,33,10,10,10,10,10,10,48,115,9,21,9,9,115,113,116,115,78,57,55,115,113,112],
[114,113,9,9,9,9,9,9,9,9,9,9,9,9,9,9,9,9,9,116,44,111,120,113,133,58,10,10,10,10,10,10,74,75,25,26,27,55,125,102,113,112,113,116,58,116,104,112],
[113,110,112,9,9,9,9,9,9,9,9,9,9,9,119,70,115,11,9,9,45,111,9,9,59,34,10,10,10,36,63,63,61,112,16,31,116,44,104,105,115,116,112,43,71,113,112,87],
[87,11,9,9,9,9,9,9,9,9,9,9,9,9,109,43,79,80,57,56,71,113,9,113,62,33,10,10,10,48,115,116,113,110,9,9,43,71,116,115,112,113,115,12,116,115,115,113],
[119,116,9,9,9,9,9,9,9,9,9,9,9,9,113,44,121,122,113,114,115,110,9,120,115,58,36,63,63,61,9,113,9,9,9,9,78,55,123,113,116,59,18,46,18,18,60,115],
[112,114,9,9,9,9,9,9,9,9,9,9,9,9,9,45,41,42,115,112,9,9,9,9,109,58,48,116,113,115,9,9,9,9,9,9,9,78,56,57,76,77,10,10,10,10,35,60],
[115,112,9,9,9,9,9,9,9,9,9,9,9,9,15,78,80,55,116,110,9,9,9,9,116,62,61,115,112,110,9,9,9,9,9,9,9,120,131,115,59,34,10,10,10,10,10,10],
[55,113,117,9,9,9,9,9,9,9,9,9,9,9,9,16,14,20,13,9,9,9,9,9,120,112,108,110,9,9,9,9,9,9,9,9,9,9,9,15,62,33,10,10,10,10,10,10],
[72,115,9,9,119,9,9,9,119,112,9,9,9,9,9,9,22,23,24,9,9,9,9,9,9,9,9,9,9,9,9,9,9,9,9,9,9,9,9,16,17,58,10,10,10,10,36,63],
[45,113,11,9,114,9,116,9,113,115,112,115,9,131,9,9,13,29,9,9,9,9,9,9,9,9,9,9,9,9,9,9,9,9,9,9,9,9,87,113,132,62,63,33,10,10,48,116],
[72,116,115,21,115,112,113,9,43,56,79,55,9,114,116,9,9,12,113,11,133,9,9,9,9,9,9,9,9,9,9,9,9,9,9,9,9,9,115,112,113,115,123,58,10,10,48,113],
[78,57,25,26,27,55,123,43,71,113,115,44,115,112,113,112,59,46,60,115,112,110,9,9,9,9,9,9,9,9,9,9,9,9,9,9,9,9,131,112,43,56,76,77,36,63,61,115],
[115,115,30,31,112,78,56,71,115,117,113,78,57,79,55,115,58,10,35,60,113,11,9,9,9,9,9,9,70,9,9,9,9,9,9,9,9,113,112,115,44,126,103,82,48,116,113,112],
[115,116,115,9,120,113,116,113,116,87,118,115,116,115,78,76,77,10,10,48,115,116,9,9,9,9,119,113,115,113,11,9,9,9,21,87,115,112,113,43,71,106,107,62,61,113,87,116],
[113,112,110,9,9,116,9,112,109,114,116,110,110,117,116,9,82,10,36,61,112,111,9,9,9,9,9,116,103,116,118,70,43,25,26,27,79,57,80,71,113,116,112,116,9,112,103,114],
[113,116,113,9,9,108,9,9,120,110,9,9,9,9,9,9,62,33,48,115,113,113,9,9,133,9,116,112,113,115,43,57,71,30,31,32,117,115,112,115,116,112,116,9,9,108,117,115],
[116,112,11,9,9,9,9,9,9,9,14,9,9,9,116,117,116,58,74,75,56,55,9,113,116,115,126,116,115,43,71,131,133,9,9,9,9,120,113,110,9,133,9,9,16,9,109,113],
[115,113,118,70,11,9,9,13,9,9,9,9,133,9,9,87,115,58,81,116,115,78,79,57,55,116,115,107,112,12,132,116,9,9,132,131,9,9,9,9,9,9,9,9,9,9,120,116],
[112,116,115,112,111,9,9,9,9,9,9,9,9,9,9,9,113,62,35,60,113,112,125,115,44,113,112,115,59,46,47,60,9,9,9,9,9,9,9,9,9,9,9,9,17,9,9,110],
[115,113,66,113,118,11,17,9,132,9,16,9,9,9,9,9,115,116,62,61,115,125,102,113,73,113,116,59,34,10,10,48,121,122,119,11,9,9,9,9,9,9,9,9,9,9,9,115],
[116,112,115,112,114,110,9,9,9,9,9,9,9,13,9,9,9,131,9,116,113,104,105,116,78,79,76,77,10,10,10,48,41,42,113,111,9,9,9,9,9,9,9,9,9,9,9,116],
[113,125,113,116,118,70,70,11,9,9,9,9,9,9,9,9,9,9,9,9,120,116,114,115,113,115,115,82,10,10,10,35,60,116,112,118,87,9,119,9,9,9,9,9,9,9,9,111],
[115,116,105,113,115,40,115,113,9,15,9,119,115,11,9,123,9,9,9,70,9,9,119,70,87,111,116,62,33,10,10,36,61,115,113,112,113,9,115,9,9,9,9,9,9,9,9,113],
[116,112,113,112,114,117,114,110,9,9,9,116,124,116,11,9,9,9,109,112,118,70,87,113,113,118,11,115,62,33,36,61,116,113,115,59,18,18,18,60,113,115,116,9,9,113,112,118],
[113,116,115,113,111,120,110,9,9,9,9,59,18,60,112,9,9,9,116,117,113,113,121,122,113,113,118,113,59,34,35,18,60,59,18,34,10,10,10,48,116,9,9,9,9,9,9,116],
[115,112,113,116,111,9,9,9,123,132,59,34,10,35,60,9,9,9,9,120,108,117,41,42,114,124,108,115,58,10,10,10,35,34,10,10,10,10,10,48,115,9,9,9,9,9,9,115],
[113,116,113,114,110,9,43,80,56,76,77,10,10,10,48,112,9,9,9,9,9,116,112,113,118,70,11,113,58,10,36,63,33,10,10,10,10,10,10,35,60,9,9,9,9,9,9,116],
[116,115,108,110,9,9,73,115,113,116,82,10,10,36,61,116,115,11,9,9,9,109,113,116,113,114,87,9,62,89,61,124,58,10,10,10,10,10,10,10,35,18,18,60,9,9,9,113],
[114,9,9,9,9,43,71,116,112,113,58,10,10,74,75,57,55,116,112,9,9,9,113,117,112,9,9,9,116,88,116,113,62,33,10,10,10,10,10,10,10,10,10,48,9,9,9,115],
[9,9,14,9,43,71,113,113,104,115,62,63,33,48,113,116,72,115,113,116,11,9,9,120,117,9,115,123,113,73,115,112,113,62,33,10,10,10,10,10,10,10,36,61,9,9,9,112],
[9,9,9,9,73,116,113,112,118,113,116,112,62,61,112,115,78,80,56,55,113,112,9,9,9,9,9,113,115,78,56,55,115,123,58,10,10,10,10,10,10,10,48,116,9,9,9,113],
[9,13,9,9,45,87,112,113,112,90,112,113,115,113,116,118,112,115,123,73,115,116,112,124,112,115,9,9,9,113,116,73,113,115,58,10,10,10,10,10,10,10,35,18,60,116,9,111],
[9,9,9,9,44,113,126,117,113,116,115,114,116,112,124,115,113,111,116,78,56,55,115,112,113,16,113,116,21,115,43,71,116,113,58,10,10,10,10,10,36,63,63,63,61,113,9,116],
[9,9,9,133,72,115,113,112,115,113,112,116,113,87,116,105,115,118,112,115,116,78,55,116,115,116,43,25,26,27,71,115,112,70,58,10,36,63,63,63,61,113,114,115,9,9,9,115],
[43,79,57,57,71,112,87,112,116,115,122,113,115,115,113,116,113,112,66,118,113,112,78,80,79,80,71,110,31,116,112,118,87,113,62,63,61,13,9,131,15,9,9,116,9,9,9,116],
[71,115,116,115,126,116,113,116,113,113,115,112,116,112,115,113,115,113,112,116,118,124,113,116,115,116,113,112,9,9,9,9,115,116,112,115,116,9,9,9,9,9,9,9,9,9,9,118],
[116,114,113,112,117,112,116,117,115,112,114,113,113,117,115,112,114,113,42,115,117,113,115,118,70,112,70,87,113,115,11,9,9,9,9,9,9,9,119,70,70,116,115,113,70,114,112,113]]