[[110,106,107,110,109,108,110,108,106,111,96,106,96,107,106,85,109,85,106,111,107,109,110,85,96,85,111,85,109,9,10,9,9,9,9,11,9,9,10,95,106,110,109,97,56,42,42,42],
[109,111,110,17,110,111,109,96,85,86,9,9,9,95,97,9,9,10,84,106,106,108,97,9,10,9,9,16,9,9,109,44,108,9,10,9,9,9,9,9,69,106,86,28,53,42,42,42],
[107,108,110,106,107,106,97,9,9,15,9,11,9,9,9,9,10,9,9,10,84,109,9,9,9,9,11,9,9,9,106,108,106,109,9,9,9,9,9,9,106,110,28,53,42,42,42,42],
[106,112,29,30,107,86,9,9,9,9,43,59,45,9,10,9,43,60,9,17,9,9,9,14,9,109,44,108,9,9,9,84,110,9,9,9,13,9,9,9,9,28,53,42,42,42,42,42],
[110,36,37,38,71,9,9,9,109,44,107,106,110,59,44,59,109,110,109,9,9,9,109,59,44,106,111,70,9,10,9,9,69,9,9,9,9,9,9,9,9,56,42,42,42,42,42,42],
[107,47,48,49,70,9,9,10,68,106,71,9,95,96,85,96,106,107,97,11,9,108,95,85,96,85,108,107,44,109,9,9,109,9,9,9,9,9,9,10,9,56,42,42,42,42,42,42],
[108,109,110,106,109,105,9,9,95,107,107,9,9,10,9,9,95,97,9,9,9,9,9,9,9,10,95,106,108,9,9,10,9,9,9,9,9,11,14,9,9,56,42,42,42,42,42,42],
[111,110,105,110,107,71,9,11,9,69,71,9,11,9,9,13,9,10,9,9,10,9,13,9,9,9,9,84,107,9,9,11,9,9,9,9,9,9,9,9,28,53,42,42,42,42,42,42],
[106,107,106,110,109,70,9,13,58,109,70,9,10,9,43,45,9,9,9,14,9,9,43,45,9,10,9,9,108,9,9,9,9,9,9,10,9,9,9,28,53,42,42,42,42,42,42,42],
[110,18,109,107,106,109,14,9,109,111,106,110,9,9,69,106,44,106,9,9,9,109,107,106,110,9,9,9,9,9,9,9,9,9,9,9,9,9,9,56,42,42,42,42,42,42,42,42],
[107,106,110,109,86,9,9,9,9,9,97,28,35,109,106,110,109,71,9,11,9,106,106,70,9,9,9,9,9,9,9,9,9,9,9,9,9,9,9,56,42,42,42,42,42,42,42,42],
[108,110,106,97,9,9,9,9,9,9,11,56,42,33,35,107,108,106,109,10,9,95,110,70,9,11,9,10,9,9,9,9,16,9,9,9,9,9,9,56,42,42,42,42,42,42,42,42],
[106,107,70,9,9,9,11,9,9,13,9,54,42,42,42,79,17,107,70,9,9,9,84,111,44,109,9,9,9,9,10,9,9,9,9,9,9,9,9,56,42,42,42,42,42,42,42,42],
[108,85,109,9,9,9,9,9,9,9,110,45,34,42,42,79,109,111,71,9,9,10,9,69,111,106,44,109,9,9,9,9,9,9,9,9,9,9,9,56,42,42,42,42,42,42,42,42],
[71,9,9,9,9,14,9,9,9,109,106,70,56,42,42,79,106,105,110,106,9,9,43,106,110,107,111,108,9,9,10,9,9,9,9,9,13,9,9,56,42,42,42,42,42,42,42,42],
[97,9,9,9,9,9,12,9,9,107,107,71,56,42,42,79,108,111,108,70,9,17,95,85,109,106,109,106,9,9,9,9,9,9,9,9,9,9,9,54,42,42,42,42,42,42,42,42],
[9,9,9,9,9,9,9,9,9,9,95,70,56,42,42,79,106,96,85,109,17,15,9,9,69,111,85,107,9,9,9,9,9,9,9,9,9,9,9,10,34,42,42,42,42,42,42,42],
[9,9,9,9,9,9,9,9,9,9,9,109,54,42,46,109,86,9,9,10,9,9,9,18,109,97,9,107,9,10,9,9,9,9,15,9,9,9,9,9,56,42,42,42,42,42,42,42],
[9,9,9,9,9,10,14,9,15,9,9,9,12,91,9,9,9,9,9,9,9,9,17,10,9,18,9,9,9,9,9,9,9,9,9,9,9,9,9,28,53,42,42,42,42,42,42,42],
[9,9,13,15,9,9,9,9,9,9,9,9,9,14,9,9,10,9,9,9,19,10,18,9,11,10,9,9,9,13,9,9,9,9,9,9,9,9,9,56,42,42,42,42,42,42,42,42],
[9,9,9,9,9,9,9,9,9,9,9,9,28,65,35,9,9,12,9,9,9,18,9,9,9,17,9,9,9,9,9,9,11,9,9,9,9,9,9,56,42,42,42,42,42,42,42,42],
[9,9,9,9,9,9,9,9,9,9,10,9,54,42,42,79,9,9,9,9,9,9,17,9,18,9,9,10,9,9,9,9,9,9,9,9,9,9,9,56,42,42,42,42,42,42,42,42],
[9,9,9,9,9,9,9,9,9,9,9,9,9,34,42,33,35,9,9,9,17,19,9,13,9,10,9,9,9,9,9,9,9,9,9,9,9,9,10,56,42,42,42,42,42,42,42,42],
[9,9,9,9,9,9,9,9,9,9,9,9,9,54,42,42,42,79,109,44,60,9,9,9,14,9,9,10,9,9,9,9,15,9,9,9,9,9,9,54,42,42,42,42,42,42,42,42],
[9,9,9,9,9,9,9,9,10,9,9,15,9,9,91,34,42,79,95,85,106,111,10,19,9,18,9,9,9,13,9,9,9,9,9,9,9,9,9,9,34,42,42,42,42,42,42,42],
[9,9,11,9,9,9,9,9,9,9,9,9,9,107,70,54,42,33,35,69,108,70,9,9,9,9,9,9,10,9,10,9,9,9,9,16,9,9,9,9,56,42,42,42,42,42,42,42],
[9,9,9,12,9,9,9,9,9,12,9,9,9,84,110,45,34,42,42,79,68,71,9,9,12,9,9,9,9,9,9,9,9,9,10,9,9,9,9,9,56,42,42,42,42,42,42,42],
[9,9,9,9,9,9,9,9,9,9,9,9,9,9,95,70,56,42,42,79,69,70,45,9,9,9,10,9,9,9,9,9,9,9,9,9,9,9,9,9,56,42,42,42,42,42,42,42],
[9,9,9,9,9,9,9,9,13,9,9,9,9,9,9,109,56,42,42,79,110,109,108,60,9,9,105,109,9,10,9,9,9,9,9,9,9,9,12,9,56,42,42,42,42,42,42,42],
[9,9,9,9,9,9,9,9,9,9,9,9,9,9,9,9,56,42,42,79,69,106,107,111,44,44,106,70,9,9,9,9,9,9,9,10,9,9,9,9,54,42,42,42,42,42,42,42],
[9,9,9,9,9,9,9,9,9,9,9,9,9,9,9,11,54,42,46,9,84,85,96,106,109,107,111,106,108,9,9,13,9,9,9,9,9,9,9,9,9,34,42,42,42,42,42,42],
[9,9,9,9,13,11,9,9,9,9,9,9,9,9,10,9,9,91,9,9,9,9,9,84,106,108,18,107,71,9,9,9,9,9,9,9,9,9,10,9,9,56,42,42,42,42,42,42],
[9,9,9,9,9,9,9,14,9,9,9,9,9,9,9,9,9,11,13,9,10,9,9,9,108,106,105,108,70,9,10,9,9,9,9,9,9,9,9,9,9,56,42,42,42,42,42,42],
[9,9,9,15,9,9,9,9,9,9,9,9,9,9,13,9,109,28,65,35,9,9,12,9,95,109,108,106,71,9,9,9,9,14,9,12,9,9,9,15,9,56,42,42,42,42,42,42],
[45,9,9,9,9,9,9,9,9,9,9,9,9,9,43,59,71,56,42,42,79,9,9,9,9,69,109,111,109,9,9,9,9,9,9,10,9,9,9,9,28,53,42,42,42,42,42,42],
[106,60,9,9,43,44,60,9,12,9,9,9,9,58,106,109,106,56,42,42,79,9,10,9,58,106,107,106,9,9,9,9,109,9,9,9,9,16,9,9,56,42,42,42,42,42,42,42],
[108,107,44,59,108,108,106,109,9,9,9,9,9,110,70,28,65,53,42,42,79,9,9,9,84,107,106,97,10,9,9,9,68,9,9,9,9,9,9,9,54,42,42,42,42,42,42,42],
[107,106,108,107,109,107,110,71,9,9,9,9,9,9,109,56,42,42,42,46,108,9,9,9,17,106,70,9,9,9,9,9,69,9,9,9,10,9,9,9,9,34,42,42,42,42,42,42],
[109,110,17,106,105,106,108,70,9,9,9,13,11,9,28,53,42,42,42,43,107,60,9,17,9,107,109,9,9,9,9,43,108,9,9,9,9,9,10,9,9,56,42,42,42,42,42,42],
[106,108,107,110,108,107,106,108,9,9,9,9,9,28,53,42,42,42,106,109,111,106,110,9,9,9,9,9,9,9,58,107,110,9,13,9,9,9,9,9,9,54,42,42,42,42,42,42],
[85,96,84,106,109,110,70,9,9,13,9,9,9,56,42,42,42,107,108,18,107,70,9,9,10,9,9,13,10,9,109,96,109,9,10,9,9,10,9,9,9,9,91,34,42,42,42,42],
[9,9,69,111,107,108,71,9,9,9,9,9,9,56,42,42,109,106,109,106,108,111,45,9,9,15,9,9,9,9,9,9,69,9,9,9,9,9,9,9,9,9,9,54,42,42,42,42],
[9,17,69,108,106,109,107,108,9,9,9,9,9,54,42,46,111,109,107,105,109,106,97,9,17,9,110,109,9,9,10,9,109,9,9,9,9,9,9,9,13,9,9,9,34,42,42,42],
[9,9,95,96,84,107,108,106,44,109,9,9,9,107,91,106,107,85,96,107,96,86,9,17,9,58,106,108,107,45,9,9,9,11,9,109,106,108,107,109,111,107,106,70,54,42,42,42],
[116,64,18,9,69,110,18,107,109,106,111,9,12,9,84,111,70,9,9,9,9,10,9,9,9,69,107,109,106,97,9,9,15,9,9,9,69,109,110,19,107,108,107,108,45,34,42,42],
[77,78,9,9,43,108,111,108,106,107,70,9,9,9,9,106,109,9,9,9,9,12,9,9,9,68,108,110,70,9,9,13,9,12,9,9,68,108,106,109,110,109,17,109,106,54,42,42],
[60,59,44,110,43,106,107,111,19,110,107,45,9,9,11,9,9,9,9,10,9,58,59,44,59,43,106,107,106,59,60,9,9,9,9,58,106,107,108,105,106,111,110,107,109,60,34,42],
[107,106,108,107,108,111,110,106,107,106,108,109,110,9,9,10,15,9,9,9,43,108,107,106,108,107,109,108,110,107,106,60,44,59,44,43,107,106,109,111,108,18,106,109,108,70,56,42]]