[[9,9,9,9,9,9,9,9,9,9,9,9,9,9,9,9,9,111,44,120,117,113,112,113,112,114,108,110,9,9,9,9,120,113,117,112,113,116,116,131,113,116,115,116,110,9,9,9],
[9,9,9,9,9,9,9,9,9,9,9,9,9,9,15,9,9,111,78,55,112,133,113,114,116,110,9,9,9,9,9,9,9,9,120,116,132,113,115,113,114,108,110,9,9,9,9,9],
[9,9,9,9,9,9,9,9,9,9,9,9,9,9,9,16,9,131,11,44,113,112,116,111,9,9,9,9,9,9,9,9,9,9,9,120,117,115,114,116,110,9,9,9,9,9,9,9],
[9,9,9,9,9,9,9,9,9,9,9,9,9,9,9,9,9,9,133,45,116,112,113,133,9,9,9,9,9,9,9,9,9,9,9,9,120,131,110,9,9,9,9,9,9,9,9,59],
[9,9,9,9,9,9,9,9,9,9,9,9,9,9,9,16,9,9,9,44,117,117,114,110,9,9,9,9,87,118,70,116,9,9,9,9,9,9,9,9,9,9,9,9,9,9,59,34],
[9,9,9,9,9,9,9,9,9,9,9,9,9,9,9,9,14,9,9,45,9,132,116,9,9,119,132,87,112,112,112,131,9,9,9,9,9,9,9,9,9,9,9,9,9,59,34,10],
[9,9,9,9,9,9,9,9,9,9,9,9,9,9,9,9,9,9,43,71,9,9,9,9,131,87,112,112,115,112,112,114,9,9,9,9,9,9,9,9,9,9,9,9,59,34,10,10],
[9,9,9,9,9,9,9,9,9,9,9,9,9,9,9,9,9,19,20,9,9,9,116,70,87,114,133,113,131,116,116,111,9,9,9,131,132,9,9,9,9,9,9,59,34,10,10,10],
[9,9,9,9,9,9,9,9,9,9,9,9,9,9,9,15,9,22,23,24,9,9,112,113,112,113,129,37,38,87,118,118,70,132,9,117,114,9,9,9,9,9,59,34,10,10,10,10],
[9,9,9,9,9,9,9,9,9,9,9,9,9,9,9,9,17,22,23,24,9,132,87,116,112,111,49,50,51,116,113,112,112,116,9,9,9,9,9,9,9,9,58,10,10,10,10,10],
[9,9,9,9,9,9,9,9,9,9,9,9,9,9,9,9,9,28,29,132,70,87,108,108,112,132,64,65,66,112,115,112,112,133,9,9,9,9,9,9,9,9,58,10,10,10,10,10],
[9,9,9,9,9,9,9,9,9,9,9,9,9,9,9,15,9,9,78,55,117,108,59,60,117,112,113,112,133,114,117,112,132,9,21,9,9,9,9,9,9,9,58,10,10,10,10,10],
[9,9,9,9,9,9,9,9,9,9,9,9,9,9,16,9,9,116,132,78,79,76,77,35,60,120,112,114,131,110,43,79,80,25,26,27,55,9,9,9,9,9,58,10,10,10,10,10],
[9,9,9,9,9,9,9,9,9,9,9,9,9,9,9,9,9,109,116,112,113,133,82,10,74,75,79,80,79,80,71,131,9,9,31,9,44,9,9,21,9,9,58,10,10,10,10,10],
[9,9,9,9,9,9,9,9,9,9,9,9,9,15,16,9,109,87,112,132,112,111,58,10,81,119,115,70,132,118,87,118,11,9,9,9,78,80,25,26,27,76,77,10,10,10,10,10],
[9,9,9,9,9,9,9,9,9,9,9,9,9,9,9,15,109,113,112,113,133,118,62,89,61,113,112,112,112,113,112,116,118,11,9,9,9,9,30,31,32,9,82,10,10,10,10,10],
[9,9,9,9,9,9,9,9,9,9,9,9,9,16,9,9,120,115,131,112,115,112,132,88,132,87,116,131,112,115,114,112,113,116,118,131,9,9,9,9,9,9,58,10,10,10,10,10],
[9,9,9,9,9,9,9,9,9,9,9,9,9,9,9,9,9,109,114,133,108,117,43,71,131,112,117,113,116,116,117,116,112,113,115,113,9,9,9,9,9,9,58,10,10,10,10,10],
[9,9,9,9,9,9,9,9,9,9,9,9,9,9,14,9,132,112,110,9,9,19,20,9,9,9,132,108,115,110,9,113,116,115,114,110,9,9,9,9,9,9,58,10,10,10,10,10],
[9,9,9,9,9,9,9,9,9,9,9,15,9,16,9,119,113,110,9,9,9,22,23,24,9,9,9,9,9,9,9,131,108,108,116,9,9,9,9,132,9,9,62,33,10,10,10,10],
[9,9,9,9,9,9,9,9,9,9,9,9,9,9,9,116,110,9,9,9,9,28,29,9,9,9,9,9,9,9,9,9,9,9,9,9,9,9,133,9,9,9,9,58,10,10,10,10],
[9,9,9,9,9,9,9,9,9,9,9,9,9,15,9,9,9,9,9,9,132,19,20,9,131,116,9,119,133,9,9,9,9,9,9,9,9,9,9,9,9,9,9,58,10,10,10,10],
[9,9,9,9,9,9,9,9,9,9,9,9,16,9,9,9,9,9,112,9,9,22,23,24,87,118,70,116,118,70,112,70,87,132,9,9,9,9,9,9,9,9,9,58,10,10,10,10],
[9,9,9,9,9,9,9,9,9,9,9,9,9,9,9,133,112,9,87,112,113,28,29,112,133,112,132,113,133,116,115,115,116,118,70,11,9,9,9,9,9,9,9,58,10,10,10,10],
[9,9,9,9,9,9,9,9,9,9,9,9,9,9,9,9,109,112,131,115,112,110,72,112,112,112,116,116,112,113,116,112,116,116,116,118,70,11,9,9,9,9,59,34,10,10,10,10],
[9,9,9,9,9,9,9,9,9,9,9,9,9,9,9,9,109,113,132,114,110,43,71,120,117,132,108,108,115,116,116,115,113,112,116,116,112,115,118,131,9,9,62,33,10,10,10,10],
[9,9,9,9,9,9,9,9,9,9,9,9,9,15,9,9,120,112,110,9,19,20,9,9,9,9,9,9,9,120,117,116,112,112,112,113,116,116,114,110,9,9,9,58,10,10,10,10],
[9,9,9,9,9,9,9,9,9,9,9,9,16,9,9,9,9,133,9,9,22,23,24,9,9,9,9,9,9,9,9,120,117,116,115,116,112,132,110,9,9,9,9,62,33,10,10,10],
[9,9,9,9,9,9,9,9,9,9,9,9,9,9,9,9,9,9,9,9,28,29,9,9,119,70,112,11,9,9,9,9,9,117,115,114,133,9,9,9,9,9,9,9,58,10,10,10],
[9,9,9,9,9,9,9,9,9,9,9,15,9,9,15,9,9,9,9,9,116,72,131,112,87,113,131,118,11,9,9,9,9,131,116,110,9,9,9,9,9,9,9,9,58,10,10,10],
[9,9,9,9,9,9,9,9,9,9,9,9,9,16,9,9,9,9,119,87,114,73,112,115,112,112,116,116,112,111,9,9,9,9,9,9,9,9,9,9,9,9,9,9,58,10,10,10],
[9,9,9,9,9,9,9,9,9,9,9,9,9,9,9,9,9,9,116,113,111,72,112,132,113,112,112,113,116,111,9,9,9,9,9,9,9,9,9,9,9,9,9,9,58,10,10,10],
[9,9,9,9,9,9,9,9,9,9,9,14,9,9,119,118,9,9,133,117,118,78,55,112,117,114,132,108,108,131,9,9,131,111,9,9,9,9,9,9,9,9,9,9,58,10,10,10],
[9,9,9,9,9,9,9,9,9,9,9,9,9,9,117,111,9,9,9,120,113,132,78,55,108,116,9,9,9,9,9,9,108,116,9,9,9,9,9,133,9,9,9,59,34,10,10,10],
[9,9,9,9,9,9,9,9,9,9,9,9,13,9,9,112,115,9,9,9,9,9,19,20,9,9,9,9,9,9,9,9,9,9,9,9,9,9,131,123,9,9,9,58,10,10,10,10],
[9,9,9,9,9,9,9,9,9,9,9,9,9,16,9,114,16,9,9,9,9,9,22,23,24,9,9,9,9,9,9,9,9,9,9,9,9,9,9,9,9,9,9,58,10,10,10,10],
[9,9,9,9,9,9,9,9,9,9,9,9,9,9,9,133,9,9,9,9,9,9,28,29,9,9,9,9,119,112,131,116,11,9,133,116,9,9,9,9,9,9,59,34,10,10,10,10],
[9,9,9,9,9,9,9,9,9,9,9,16,9,9,9,9,9,9,132,112,70,9,43,71,119,132,116,112,87,112,116,115,113,113,115,110,9,9,9,9,9,9,58,10,10,10,10,10],
[9,9,9,9,9,9,9,9,9,9,9,9,15,9,9,9,9,119,112,115,108,131,72,87,130,39,40,115,116,112,116,113,112,116,114,9,9,9,9,9,9,59,34,10,10,10,10,10],
[9,9,9,9,9,9,9,9,15,9,9,9,9,9,9,87,118,112,132,114,43,79,71,109,52,53,54,131,116,115,113,115,114,108,110,9,9,9,9,9,9,58,10,10,10,10,10,10],
[9,15,9,9,9,9,9,9,9,9,131,9,9,9,119,112,112,116,116,111,72,119,112,115,67,68,69,115,116,132,112,114,132,9,9,9,9,9,9,9,59,34,10,10,10,10,10,10],
[9,9,9,16,9,16,9,9,9,9,132,124,9,9,117,113,131,112,43,56,71,112,116,112,133,87,116,113,112,116,112,110,9,9,9,9,9,9,59,18,34,10,10,36,63,63,33,10],
[9,9,9,9,15,9,9,9,9,9,9,9,9,9,9,120,115,19,20,133,116,112,113,112,116,113,114,115,116,114,110,9,9,9,9,9,9,9,58,10,10,10,36,61,133,131,58,10],
[9,9,9,9,9,9,9,9,9,9,9,9,9,9,9,9,9,22,23,24,132,117,112,115,114,108,108,108,114,110,9,9,9,9,9,9,9,59,34,10,10,10,48,132,121,122,58,10],
[112,131,9,9,9,9,119,132,118,9,9,9,9,9,9,9,9,28,29,9,9,116,108,108,133,9,9,9,9,9,9,9,9,9,9,9,9,58,10,10,10,10,48,133,41,42,58,10],
[112,118,133,116,118,70,112,113,112,118,9,9,9,119,131,9,9,19,20,9,9,9,9,9,9,9,9,9,9,9,132,9,9,9,9,9,59,34,10,10,10,10,48,131,123,59,34,10],
[112,113,112,112,133,115,112,133,112,115,118,70,70,112,115,70,9,22,23,24,9,9,9,9,9,9,9,9,9,9,9,9,9,9,9,9,58,10,10,10,10,10,35,18,18,34,10,10],
[112,115,112,112,113,112,112,112,113,112,116,116,116,112,112,116,112,28,29,9,9,9,9,9,9,9,9,9,9,9,9,9,9,9,9,9,58,10,10,10,10,10,10,10,10,10,10,10]]