[[112,112,112,113,112,115,111,9,9,9,9,9,9,9,9,9,9,9,9,9,9,116,112,116,112,113,111,58,10,10,10,10,10,10,10,10,10,10,10,10,10,10,10,10,10,10,10,10],
[116,115,112,112,116,112,114,9,9,9,9,9,9,9,9,9,9,9,9,9,9,131,113,112,114,115,110,58,10,10,10,10,10,10,10,10,10,10,10,10,10,10,10,10,10,10,10,10],
[112,112,116,112,114,133,9,9,9,9,9,9,9,9,9,9,9,9,9,9,9,9,120,113,133,9,9,62,33,10,10,10,10,10,10,10,10,10,10,10,10,10,10,10,10,10,10,10],
[112,115,112,116,115,9,9,9,9,9,9,9,9,9,87,115,70,11,9,9,9,9,9,9,9,9,9,9,62,33,10,10,10,10,10,10,10,36,63,63,63,63,33,10,10,10,10,10],
[112,112,112,112,112,118,11,9,9,9,9,9,87,113,112,113,112,132,131,9,9,9,9,9,9,9,9,9,9,62,33,10,10,10,10,10,36,61,9,9,9,9,62,33,10,10,10,10],
[116,112,116,113,113,112,111,9,9,9,9,9,120,132,115,116,112,115,113,118,9,9,9,9,9,9,9,9,119,118,62,33,10,10,10,10,48,9,9,9,9,9,9,58,10,10,10,10],
[112,113,112,112,116,112,111,9,9,9,9,9,9,9,120,112,113,114,108,133,9,9,9,9,133,70,70,132,87,112,111,58,10,10,10,36,61,9,9,9,9,9,9,58,10,10,10,10],
[112,115,112,112,112,116,132,9,9,16,9,9,9,9,9,133,108,110,9,9,9,9,9,119,87,112,115,112,113,116,111,58,10,10,36,61,9,9,9,9,9,9,9,62,33,10,10,10],
[113,112,112,108,117,112,111,9,9,9,9,9,9,9,9,9,9,9,9,9,9,9,9,109,112,113,112,112,112,115,111,58,10,10,48,9,9,9,9,9,9,9,9,9,62,33,10,10],
[112,113,114,9,116,112,111,9,9,9,9,9,9,9,9,9,9,9,9,9,9,9,9,132,112,116,112,116,113,112,111,58,10,10,48,9,9,9,9,9,9,9,9,9,9,58,10,10],
[114,133,9,9,132,108,133,9,9,9,15,9,9,9,9,9,9,9,9,9,9,9,9,9,133,108,115,112,115,112,131,58,10,10,48,9,9,9,9,9,9,9,9,9,9,58,10,10],
[110,9,9,9,9,9,9,9,9,9,9,9,9,9,119,116,9,9,9,9,9,9,9,9,9,9,117,113,112,110,59,34,10,10,48,9,9,9,9,9,9,9,9,9,9,58,10,10],
[9,9,9,9,9,9,9,9,9,9,9,9,9,133,112,112,115,132,11,9,9,9,9,9,9,9,112,115,116,111,58,10,10,10,48,9,9,9,9,9,9,9,9,9,9,58,10,10],
[9,9,9,9,9,9,9,9,9,9,9,9,112,112,113,112,116,112,111,9,9,9,9,9,9,132,113,112,112,131,58,10,10,10,48,9,9,9,9,9,9,9,9,9,9,58,10,10],
[9,9,9,9,9,9,9,9,9,133,112,116,115,112,112,112,115,112,111,9,9,9,9,9,9,112,115,112,133,9,58,10,10,10,48,9,9,9,9,9,9,9,9,9,9,58,10,10],
[9,9,9,9,9,9,9,9,119,112,113,112,112,116,112,113,112,114,133,9,9,9,9,9,9,133,114,110,9,9,58,10,10,10,48,9,9,9,9,9,9,9,9,9,9,58,10,10],
[9,9,9,9,9,9,9,9,112,112,112,112,116,113,116,112,112,132,9,9,9,9,9,9,9,9,9,9,9,9,58,10,10,10,35,60,9,9,9,9,9,9,9,9,59,34,10,10],
[133,9,9,9,9,9,9,9,131,112,116,115,112,112,112,114,110,133,9,9,9,9,9,9,9,9,9,9,9,9,62,33,10,10,10,48,9,9,9,9,9,9,9,9,58,10,10,10],
[112,112,118,11,9,9,9,9,112,112,113,112,112,112,131,112,9,9,9,9,9,9,9,9,9,15,9,9,9,9,9,62,33,10,10,35,60,9,9,9,9,9,9,9,58,10,10,10],
[113,112,115,111,9,9,9,9,116,112,115,112,112,114,110,9,9,9,9,116,9,9,16,9,16,9,15,9,9,9,9,9,62,33,10,36,61,9,9,9,9,9,9,9,58,10,10,10],
[112,131,112,133,9,9,9,133,112,112,112,112,133,9,9,9,9,132,114,132,9,9,9,15,9,9,9,9,9,9,9,9,9,62,63,61,9,9,9,9,9,9,9,9,62,33,10,10],
[112,114,110,9,9,9,87,112,113,115,112,114,9,9,9,9,9,120,131,9,9,9,15,9,9,9,9,9,9,9,9,9,9,9,9,9,9,9,9,9,9,9,9,9,9,62,33,10],
[115,112,111,9,9,9,117,113,116,112,112,111,9,9,9,9,9,9,9,9,9,16,9,9,9,9,9,9,9,9,9,9,9,9,9,9,9,9,9,9,9,9,9,9,9,9,58,10],
[108,108,132,9,9,9,120,108,108,117,115,112,132,9,9,9,9,9,9,14,9,9,15,9,9,9,9,9,9,9,9,9,9,9,9,9,9,9,9,9,9,9,9,9,9,9,58,10],
[79,80,55,9,21,9,43,80,79,55,116,117,111,9,9,9,9,9,9,9,15,9,9,9,15,9,9,9,9,9,9,9,9,9,59,18,18,60,9,9,9,9,9,9,9,9,58,10],
[9,9,78,25,26,27,71,119,132,78,55,112,114,9,9,9,9,9,9,9,9,16,9,15,9,9,9,9,9,9,9,9,9,59,34,10,10,35,60,9,9,9,9,9,9,9,58,10],
[112,9,9,9,31,9,119,87,112,11,78,55,133,9,9,9,9,9,9,9,9,9,15,9,16,9,9,16,9,9,9,9,59,34,10,10,10,10,48,9,9,9,9,9,9,9,58,10],
[112,112,133,9,9,9,131,112,112,113,111,44,9,9,9,9,9,9,9,9,9,9,9,9,9,9,14,9,9,9,9,9,58,10,10,10,10,10,35,60,9,9,9,9,9,9,58,10],
[116,113,111,9,9,9,109,116,112,112,111,45,9,9,9,9,9,9,9,9,116,112,118,11,9,9,15,9,16,9,15,9,62,33,10,10,10,10,36,61,9,9,9,9,9,9,58,10],
[112,112,111,9,9,9,109,112,116,114,110,78,55,9,9,9,9,9,9,119,112,116,112,116,11,9,9,9,9,9,9,9,9,62,33,10,10,10,48,9,9,9,9,9,9,9,58,10],
[113,115,131,9,9,9,132,113,112,112,9,9,20,9,9,9,9,9,9,112,112,113,116,115,112,132,9,9,9,9,9,9,9,9,62,33,10,10,48,9,9,9,9,9,9,9,58,10],
[112,114,132,9,9,9,120,112,114,133,9,22,23,24,9,9,132,9,119,87,113,116,112,113,111,9,9,9,9,9,9,9,16,9,9,62,33,10,48,9,9,9,9,9,9,9,58,10],
[112,111,9,9,9,9,9,133,9,9,9,9,29,9,9,9,112,112,112,115,108,108,108,115,118,112,9,9,15,9,9,9,9,9,9,9,58,10,48,9,9,9,9,9,9,9,58,10],
[112,111,9,9,9,9,9,9,9,9,9,9,78,79,79,55,132,116,112,110,43,80,79,55,112,133,9,9,9,13,9,9,9,9,9,9,58,10,48,9,9,9,9,9,9,9,58,10],
[115,118,11,9,9,9,9,9,9,9,9,87,131,70,70,78,55,133,43,80,71,113,11,44,115,9,9,9,9,9,9,15,9,9,9,59,34,10,48,9,9,9,9,9,9,9,58,10],
[112,112,111,9,9,9,9,9,9,133,116,112,116,115,112,112,78,79,71,112,112,116,111,44,112,21,9,9,9,9,9,9,9,9,59,34,10,36,61,9,9,9,9,9,9,9,58,10],
[112,114,133,9,9,9,9,9,9,132,108,108,113,112,115,116,70,70,115,116,114,108,111,78,25,26,27,55,9,9,9,9,59,18,34,10,36,61,9,9,9,9,9,9,9,9,58,10],
[115,114,9,9,9,9,9,9,9,9,9,9,112,132,112,113,112,112,112,113,111,9,133,132,9,31,9,45,9,59,18,18,34,10,10,36,61,9,9,9,9,9,9,9,9,9,58,10],
[112,110,9,9,9,9,9,9,9,9,9,9,133,108,117,112,115,113,112,114,9,9,9,9,9,9,9,78,76,77,10,10,10,10,36,61,9,9,9,9,9,9,9,9,9,59,34,10],
[133,9,9,9,9,9,9,9,9,9,9,9,9,9,131,108,112,114,108,131,9,9,9,9,9,9,9,9,9,82,10,10,10,36,61,9,9,9,9,9,9,9,9,9,9,58,10,10],
[9,9,9,9,9,9,9,9,9,9,9,9,9,9,9,9,133,132,9,9,9,9,9,9,9,9,9,9,59,34,10,10,10,48,9,9,9,9,9,9,9,9,9,9,59,34,10,10],
[9,9,9,9,9,9,9,9,9,9,9,9,9,9,9,9,9,9,9,9,9,9,9,9,9,9,9,9,58,10,10,10,10,48,9,9,9,9,9,9,9,9,9,9,58,10,10,10],
[133,9,9,9,9,9,9,9,9,9,9,9,9,9,9,9,9,9,9,9,9,9,9,9,9,9,9,9,58,10,10,10,10,48,9,9,9,9,9,9,9,9,9,9,58,10,10,10],
[118,70,11,9,9,9,9,9,9,9,9,9,9,9,9,9,9,9,9,9,9,9,9,9,9,119,133,9,58,10,10,10,10,48,9,9,9,9,9,9,9,9,59,18,34,10,10,10],
[112,113,111,9,9,9,9,9,9,9,9,9,9,9,9,9,9,9,9,9,9,9,9,9,132,87,111,9,58,10,10,10,10,48,9,9,9,9,9,9,59,18,34,10,10,10,10,10],
[115,112,133,9,9,9,9,9,9,116,11,9,9,9,9,9,9,9,9,9,9,9,9,119,87,133,110,59,34,10,10,10,10,35,60,9,9,9,9,59,34,10,10,10,10,10,10,10],
[113,111,9,9,9,9,9,132,112,87,118,115,133,9,9,9,9,9,9,9,9,9,131,87,112,111,59,34,10,10,10,10,10,10,35,18,18,18,18,34,10,10,10,10,10,10,10,10],
[116,112,132,9,9,9,9,113,112,113,112,112,111,9,9,9,9,9,9,9,9,119,87,112,113,110,58,10,10,10,10,10,10,10,10,10,10,10,10,10,10,10,10,10,10,10,10,10]]