[[118,34,120,119,120,140,119,121,140,119,140,120,135,12,12,12,12,12,12,12,12,12,12,12,12,12,12,12,12,12,12,12,12,12,12,12,12,12,12,12,12,12,12,12,12,12,12,12],
[46,47,140,118,34,140,9,9,9,9,9,9,80,33,12,12,28,29,77,33,12,12,12,12,12,12,12,12,12,12,12,12,12,12,12,12,12,12,12,12,12,12,12,12,12,12,12,12],
[119,140,119,46,47,119,9,118,34,121,9,9,92,45,12,12,40,41,89,45,134,12,12,12,12,12,12,12,12,12,12,12,12,12,12,12,12,12,12,12,12,12,12,12,12,12,12,12],
[140,120,120,119,140,120,9,46,47,140,9,9,9,9,80,78,108,109,9,9,136,12,12,12,12,12,12,12,12,12,12,12,12,12,12,12,12,12,12,12,12,12,12,12,12,28,32,77],
[120,140,140,119,140,9,9,140,119,120,119,9,9,9,92,90,114,115,9,9,80,79,33,12,12,12,12,12,12,12,12,12,12,12,12,12,12,12,12,12,12,12,12,12,12,43,44,89],
[140,119,140,9,9,120,9,9,119,9,9,120,9,9,9,9,9,9,9,9,92,91,45,12,12,12,12,12,12,12,12,12,12,12,12,12,12,12,12,12,12,12,12,12,12,75,76,9],
[52,37,64,117,9,9,9,9,9,9,9,9,9,9,9,72,73,9,9,9,9,9,9,136,12,12,12,12,12,12,12,12,12,12,12,12,12,12,12,12,12,12,12,12,12,87,88,9],
[137,9,62,64,9,119,121,119,9,120,9,9,93,94,9,83,84,9,9,139,9,9,9,80,78,77,30,12,12,12,12,12,12,12,12,12,12,12,12,12,12,12,12,12,12,98,99,9],
[11,116,9,36,9,9,140,140,9,9,9,9,102,103,9,9,9,9,9,9,9,9,116,92,90,89,42,12,12,12,12,12,12,12,12,12,12,12,12,12,12,12,12,12,12,75,76,9],
[9,9,13,49,138,9,120,9,9,120,119,9,9,9,9,9,9,117,116,95,96,9,9,9,9,9,9,136,12,12,12,12,12,12,12,12,12,12,12,12,12,12,31,78,77,108,109,9],
[9,9,9,53,9,9,9,9,119,140,9,128,74,9,9,137,9,70,71,104,105,9,9,14,9,9,9,135,12,12,12,12,12,12,12,12,12,12,12,12,12,12,43,44,89,114,115,9],
[9,9,137,38,9,15,9,9,9,9,9,85,86,9,9,9,9,81,82,9,9,9,9,62,25,9,9,80,79,78,77,78,77,79,77,78,77,79,77,79,77,78,108,109,9,9,9,9],
[35,9,9,62,16,17,18,39,52,56,64,9,9,9,9,9,9,9,137,9,9,9,9,9,9,9,9,92,91,90,89,90,89,91,89,90,89,91,89,91,89,90,114,115,9,9,14,9],
[9,9,11,9,9,19,9,9,139,9,36,9,9,9,116,9,9,9,9,9,129,97,9,9,9,9,9,9,9,9,9,137,9,9,9,9,14,9,9,9,9,9,9,9,9,9,62,64],
[9,9,9,116,9,9,61,9,9,9,49,9,138,9,9,9,14,9,9,9,106,107,9,9,93,94,9,9,14,9,9,9,9,9,9,9,38,9,117,9,9,9,9,9,70,71,9,62],
[9,9,9,9,9,9,9,9,9,9,62,52,39,64,9,9,62,64,9,9,9,9,9,9,102,103,9,9,49,9,9,9,9,27,37,50,65,9,9,9,9,116,9,9,81,82,9,9],
[117,9,9,9,35,117,9,9,11,9,11,9,137,55,137,9,9,53,9,72,73,9,137,9,9,9,9,9,53,9,116,9,9,9,9,9,9,9,9,9,9,9,9,9,116,72,73,9],
[9,35,9,9,9,9,9,9,9,9,9,9,63,65,9,9,9,26,9,83,84,9,9,9,9,9,9,9,36,9,137,117,9,9,117,9,9,9,9,137,9,9,9,9,117,83,84,9],
[9,9,9,9,9,9,9,9,9,9,9,35,36,116,9,9,9,9,9,9,9,9,9,9,9,138,9,9,26,9,9,139,9,9,9,9,139,9,63,50,64,9,116,9,9,9,9,9],
[9,9,9,13,9,10,9,9,9,137,63,37,65,9,9,70,71,9,9,27,54,37,50,25,9,9,9,9,9,9,9,9,9,116,9,9,9,9,49,137,62,50,64,117,9,9,137,9],
[9,137,9,9,9,9,9,9,9,9,20,138,9,9,9,81,82,9,9,9,9,9,9,9,9,63,25,9,9,95,96,9,9,9,9,138,63,37,65,9,9,9,20,9,9,9,9,9],
[13,9,9,9,11,9,9,9,9,21,22,23,9,9,9,9,9,9,9,9,93,94,9,9,9,51,9,9,9,104,105,9,9,63,37,50,65,9,9,9,9,21,22,23,9,139,9,9],
[9,9,9,9,9,9,117,9,116,9,24,9,9,9,117,9,9,116,9,9,102,103,9,9,27,65,9,9,9,137,9,9,9,53,116,9,13,9,137,9,9,9,24,9,9,9,9,9],
[9,9,139,9,9,9,9,9,11,9,62,37,50,64,9,9,9,9,9,9,9,9,9,9,9,9,116,9,9,9,9,9,117,38,9,9,9,9,9,9,116,9,38,9,9,9,117,9],
[9,13,117,9,13,9,9,9,9,117,9,9,137,49,9,9,137,9,9,9,138,9,9,9,9,9,9,9,9,9,9,9,9,51,9,9,9,9,9,9,9,9,62,54,64,9,9,9],
[9,9,116,137,138,9,9,9,9,9,116,9,9,62,37,50,54,39,52,56,64,9,9,117,9,9,9,9,117,15,9,139,9,55,9,9,117,9,9,15,9,9,9,137,36,9,9,9],
[9,9,117,116,116,117,35,9,9,9,9,9,9,9,9,139,9,9,9,137,51,9,9,9,9,9,63,37,16,17,18,52,56,65,9,10,9,9,9,9,9,9,9,9,49,137,9,9],
[9,9,35,9,139,137,116,117,139,9,9,9,9,9,9,9,9,9,9,117,55,9,9,9,9,9,55,137,137,19,9,9,117,9,9,9,9,9,11,9,9,116,9,9,53,9,9,9],
[10,9,9,9,117,116,35,116,138,9,9,9,15,9,66,67,9,9,9,9,38,9,116,9,9,63,65,9,9,9,9,9,9,9,9,9,9,9,9,9,9,9,9,9,62,64,9,9],
[9,9,137,9,9,9,9,137,11,9,9,9,9,9,68,69,9,9,9,9,62,37,64,138,9,36,9,117,9,9,116,13,9,9,13,9,9,9,9,35,9,9,9,13,9,49,139,137],
[9,9,9,9,9,9,9,9,9,9,13,9,9,9,9,9,9,9,9,9,9,13,62,50,54,65,9,9,9,9,11,9,9,9,9,9,116,137,9,9,9,9,116,9,9,62,37,64],
[9,9,15,9,9,9,9,139,137,9,9,9,9,35,9,9,9,11,9,9,9,9,9,9,116,9,35,9,9,9,9,9,9,9,9,9,137,116,11,9,9,9,9,9,9,9,9,53],
[9,9,9,9,11,9,9,117,116,137,9,9,9,9,9,9,9,9,9,9,117,9,9,9,9,9,9,48,9,9,138,116,139,35,139,9,9,116,117,138,9,9,13,9,9,116,9,36],
[35,9,9,9,9,9,9,9,13,116,35,139,117,116,138,9,9,9,9,9,9,9,9,9,9,9,9,9,9,11,139,117,116,116,116,138,9,9,13,116,137,9,9,9,9,9,9,49],
[9,9,9,9,9,9,9,9,9,138,117,116,35,137,117,9,9,9,11,9,9,9,9,15,9,9,9,9,137,137,116,137,139,117,116,9,10,9,9,139,138,35,9,9,9,9,9,38],
[9,9,117,9,13,9,9,9,9,9,9,9,9,9,116,139,13,9,9,9,137,9,9,9,9,9,9,117,116,35,9,9,9,9,9,9,9,9,137,117,137,117,138,9,10,9,9,62],
[9,9,9,9,9,9,15,9,9,9,9,9,10,9,9,116,137,9,9,9,35,9,9,9,9,9,35,117,138,9,9,9,13,9,9,9,9,9,9,116,137,139,116,9,9,9,9,13],
[9,9,9,9,9,9,9,9,35,9,9,9,9,9,9,9,9,9,9,9,9,9,9,9,9,117,9,137,9,9,9,9,9,9,9,9,35,9,9,9,9,35,116,9,15,9,9,9],
[35,9,9,10,9,9,9,9,9,9,9,9,9,9,35,9,9,9,9,9,9,9,9,9,9,9,9,9,9,9,9,9,9,9,9,9,9,9,9,9,9,137,139,9,9,9,137,9],
[9,9,9,9,9,9,9,9,9,9,11,9,9,9,9,9,9,10,9,9,9,9,9,9,13,9,9,9,11,9,9,9,9,15,9,9,9,9,9,9,9,117,139,137,138,9,9,10],
[9,9,9,9,9,9,9,117,9,9,9,9,9,9,9,9,9,9,9,9,9,15,9,9,9,35,9,9,9,9,9,9,9,9,9,9,9,9,11,9,137,9,9,13,117,9,9,9],
[9,13,9,9,11,9,9,9,9,137,13,9,139,116,138,9,9,9,9,9,9,9,9,9,9,9,9,9,9,9,9,117,9,9,9,9,9,9,9,9,9,9,9,9,9,9,9,9],
[137,9,9,9,9,9,9,138,117,139,116,9,116,117,137,35,9,116,139,117,9,9,9,10,9,9,9,9,9,9,9,9,9,9,9,9,9,9,9,9,9,9,9,9,9,9,13,9],
[9,9,9,9,9,9,137,35,9,9,137,9,9,139,116,117,116,116,116,138,9,9,9,9,9,9,9,35,9,9,9,9,9,9,9,13,9,9,9,9,9,9,9,9,9,9,9,9],
[9,9,9,35,9,9,9,9,9,9,9,9,9,9,9,9,117,35,117,137,116,9,9,9,9,9,9,9,9,9,9,11,9,9,9,9,9,9,9,35,9,9,9,9,10,9,9,9],
[9,9,9,9,9,9,9,9,9,9,9,9,9,9,9,11,137,9,9,11,117,139,117,137,9,9,9,9,9,9,9,9,9,9,9,9,9,9,9,9,9,9,9,9,9,9,9,11],
[11,9,35,9,9,9,9,9,9,9,13,9,9,9,9,9,9,15,9,9,9,9,9,9,9,9,9,9,9,13,9,9,9,9,9,9,9,9,9,9,9,117,9,9,9,9,9,9],
[9,9,9,9,9,10,9,9,9,9,9,9,9,13,9,9,9,9,9,9,9,9,9,9,9,9,10,9,9,9,9,9,137,9,9,9,11,9,9,9,9,9,35,9,9,11,9,9]]